You go out with your friends to watch the latest horror movie called "Madman Mercer."  In the movie you see Madman Mercer chasing people through Chinatown in the middle of the night with a machete.  As you are watching you suddenly fall asleep.  When you wake up you are on the cold damp ground of Chinatown.  You can hear the high speed swings of a machete.  In your mind you think "Oh no". 
Escape the Movie
An Interactive Fiction by Dylan Zhang
Release 1 / Serial number 131009 / Inform 7 build 6G60 (I6/v6.32 lib 6/12N) SD

Cultural Plaza
The outside of all the stores around you.

You can see Madman Mercer here.

>go s
Downtown
A street lighted with street light.

You can see an Instruction Manual here.

>go n
Cultural Plaza
The outside of all the stores around you.

>go s
Downtown
A street lighted with street light.

You can see Madman Mercer here.

There is a large furry tabby cat here.

>go n
Cultural Plaza
The outside of all the stores around you.

>x madman
You can't see any such thing.

>x madman
You can't see any such thing.

>go n
Stage
A large stage used for lion dance shows, and many other performances.

You can see fancy key here.

>go s
Cultural Plaza
The outside of all the stores around you.

>go s
Downtown
A street lighted with street light.

>x mad man
You can't see any such thing.

>x madman
You can't see any such thing.

>go s
You can't go that way.

>go e
Fruit Stands
Many different containers of fruit are on the stands.

You can see a basket of fruit (in which is Flashlight) here.

>go w
Downtown
A street lighted with street light.

>go w
Fish Market
Fishy smelling market where you can hear the loud clerk yelling "Come get yo ninety nine sense feesh".

>go e
Downtown
A street lighted with street light.

>go n
Cultural Plaza
The outside of all the stores around you.

>go n
Stage
A large stage used for lion dance shows, and many other performances.

You can see fancy key here.

* * *

>go s
Cultural Plaza
The outside of all the stores around you.

>go n
Stage
A large stage used for lion dance shows, and many other performances.

You can see fancy key here.

>go e
You can't go that way.

There is a large furry tabby cat here.

>go s
Cultural Plaza
The outside of all the stores around you.

You can see Madman Mercer here.

There is a large furry tabby cat here.

>go e
Video Store
A rental video shop, with stands and stands of videos.

You can see titanium key here.

>go w
Cultural Plaza
The outside of all the stores around you.

>go w
Restaurant
A nice little Chinese restaurant where you can smell all of the Char-Siu Buns.

You can see a char-siu bau (closed) here.

>go e
Cultural Plaza
The outside of all the stores around you.

>go ne
Furniture Store
Lots of furniture clutter the store.

You can see green key here.

>go se
You can't go that way.

>go sw
Cultural Plaza
The outside of all the stores around you.

>go nw
Hair Salon
A hair salon with little pieces of hair on the floor everywhere.

You can see a wad of hair (closed) and a scissor here.

>go se
Cultural Plaza
The outside of all the stores around you.

>go sw
Darkness
It is pitch dark, and you can't see a thing.

>go ne
Cultural Plaza
The outside of all the stores around you.

You can see Madman Mercer here.

There is a large furry tabby cat here.

>go sw
Darkness
It is pitch dark, and you can't see a thing.

>go ne
Cultural Plaza
The outside of all the stores around you.

>go se
Bathroom
A stinky smelling bathroom.

You can see beautiful key here.

>restart
Are you sure you want to restart?

* * *

>go s
Downtown
A street lighted with street light.

You can see an Instruction Manual here.

>go e
Fruit Stands
Many different containers of fruit are on the stands.

You can see a basket of fruit (in which is Flashlight) here.

* * *

>go e
Downtown
A street lighted with street light.

>go n
Cultural Plaza
The outside of all the stores around you.

You can see Madman Mercer here.

Madman Mercer is running wildly at you, swinging his machete, and cursing at you.

>go e
Video Store
A rental video shop, with stands and stands of videos.

You can see titanium key here.

>go w
Cultural Plaza
The outside of all the stores around you.

You can see Madman Mercer here.

Madman Mercer is running wildly at you, swinging his machete, and cursing at you.

>go s
Downtown
A street lighted with street light.

>go e
Fruit Stands
Many different containers of fruit are on the stands.

You can see a basket of fruit (in which is Flashlight) here.

I beg your pardon?

>x basket
A glowing basket containing many glowing apples.

In the basket of fruit is Flashlight.

>take flashlight
taken

>i
You are carrying:
  Flashlight (providing light)

>go w
Downtown
A street lighted with street light.

>go n
Cultural Plaza
The outside of all the stores around you.

You can see Madman Mercer here.

Madman Mercer is running wildly at you, swinging his machete, and cursing at you.

>go w
Restaurant
A nice little Chinese restaurant where you can smell all of the Char-Siu Buns.

You can see a char-siu bau (closed) here.

>eat char-siu bau
(first taking the char-siu bau)
you start eating the char-siu bau, and suddenly you bite something hard.  You see that it is a wooden key.

>take key
You already have that.

>i
You are carrying:
  wooden key
  Flashlight (providing light)

>go e
Cultural Plaza
The outside of all the stores around you.

You can see Madman Mercer here.

Madman Mercer is running wildly at you, swinging his machete, and cursing at you.

>go s
Downtown
A street lighted with street light.

>go s
You can't go that way.

>go n
Cultural Plaza
The outside of all the stores around you.

You can see Madman Mercer here.

Madman Mercer is running wildly at you, swinging his machete, and cursing at you.

>go n
Stage
A large stage used for lion dance shows, and many other performances.

You can see fancy key here.

>go s
Cultural Plaza
The outside of all the stores around you.

You can see Madman Mercer here.

Madman Mercer is running wildly at you, swinging his machete, and cursing at you.

>go e
Video Store
A rental video shop, with stands and stands of videos.

You can see titanium key here.

>go e
You can't go that way.

>go w
Cultural Plaza
The outside of all the stores around you.

You can see Madman Mercer here.

Madman Mercer is running wildly at you, swinging his machete, and cursing at you.

>go w
Restaurant
A nice little Chinese restaurant where you can smell all of the Char-Siu Buns.

>go w
You can't go that way.

>go e
Cultural Plaza
The outside of all the stores around you.

You can see Madman Mercer here.

Madman Mercer is running wildly at you, swinging his machete, and cursing at you.

* * *

>go s
Downtown
A street lighted with street light.

>go e
Fruit Stands
Many different containers of fruit are on the stands.

You can see a basket of fruit (empty) here.

>go w
Downtown
A street lighted with street light.

* * *

>go s
Downtown
A street lighted with street light.

You can see an Instruction Manual here.

>x manual
How to Build a Film Projector for Dummies:

Steps:

*note: must combine in this order

1. Combine Light Source with Reflector

2. Combine Light Source + Reflector Thing with Condenser Lens

3. Combine Light Source + Reflector + Condenser Lens Thing with Imaging Lens

4. Combine Light Source + Reflector + Condenser Lens + Imaging Lens Thing with Shutter

5. Combine Light Source + Reflector + Condenser Lens + Imaging Lens + Shutter Thing with Viewing Screen

6. After combining you should have a Film Projector

7. Find Film

>go s
Vault
Snug yet paranoid, this represents the state of the art in cheerless security.

A mammoth safe, with a dial which can spin to any number, has pride of place. It must weigh about the same as a small car, so don't get any ideas.

You can also see Madman Mercer here.

Madman Mercer walks to another room.

>spin dial to 1131
Click! and nothing else happens.

>spin safe to 1131
You can't see any such thing.

>open safe
You can't see any such thing.

>spin dial
I didn't understand that sentence.

>open safe
You can't see any such thing.

>spin dial to 1384
Clonk! and the safe door swings slowly open, revealing a silver florin.

>restart
Are you sure you want to restart?

* * *

>go e
Video Store
A rental video shop, with stands and stands of videos.

You can see titanium key here.

Madman Mercer is running wildly at you, swinging his machete, and cursing at you.

>go n
You can't go that way.

>go s
You can't go that way.

Madman Mercer is running wildly at you, swinging his machete, and cursing at you.

>go e
You can't go that way.

Madman Mercer is running wildly at you, swinging his machete, and cursing at you.

    *** You have died ***

In that game you scored 0 out of a possible 0, in 4 turns.

Would you like to RESTART, RESTORE a saved game, QUIT, or UNDO the last command?

>undo
Video Store
[Previous turn undone.]

>go w
Cultural Plaza
The outside of all the stores around you.

Madman Mercer is running wildly at you, swinging his machete, and cursing at you.

    *** You have died ***

In that game you scored 0 out of a possible 0, in 4 turns.

Would you like to RESTART, RESTORE a saved game, QUIT, or UNDO the last command?

* * *

>x madman mercer
A white guy about 5 foot 3 inches with curly brown hair wearing a hockey mask.  He is holding a machete.

    *** You have died ***

In that game you scored 0 out of a possible 0, in 1 turn.

Would you like to RESTART, RESTORE a saved game, QUIT, or UNDO the last command?

* * *

>x madman
A white guy about 5 foot 7 inches with curly brown hair wearing a hockey mask.  He is holding a machete.

Madman Mercer walks to another room.

>x madman
You can't see any such thing.

>go s
Downtown
A street lighted with street light.

>go n
Cultural Plaza
The outside of all the stores around you.

>go ne
Furniture Store
Lots of furniture clutter the store.

You can see shutter and green key here.

>go sw
Cultural Plaza
The outside of all the stores around you.

>go s
Downtown
A street lighted with street light.

* * *

>go n
Cultural Plaza
The outside of all the stores around you.

>go e
Video Store
A rental video shop, with stands and stands of videos.

You can see Viewing Screen and titanium key here.

>take viewing screen
Taken.

>go w
Cultural Plaza
The outside of all the stores around you.

>go nw
Hair Salon
A hair salon with little pieces of hair on the floor everywhere.

You can see Light Source, a wad of hair (closed), and a scissor here.

>take light source
Taken.

>i
You are carrying:
  Light Source
  Viewing Screen

>combine light source with viewing screen
You can't combine Light Source and Viewing Screen into anything useful.
Try another combination of things.

>i
You are carrying:
  Light Source
  Viewing Screen

>go s
You can't go that way.

>go s
You can't go that way.

Madman Mercer walks to another room.

>go se
Cultural Plaza
The outside of all the stores around you.

>go w
Restaurant
A nice little Chinese restaurant where you can smell all of the Char-Siu Buns.

You can see Reflector and a char-siu bau (closed) here.

>take reflector
Taken.

>i
You are carrying:
  Reflector
  Light Source
  Viewing Screen

>combine reflector with light viewing screen thingy
I only understood you as far as wanting to combine Reflector with Light Source.

>combine reflector with light viewing screen thingy
I only understood you as far as wanting to combine Reflector with Light Source.

>restart
Are you sure you want to restart?

* * *

>kill madman mercer
Madman Mercer is unphased by your weak punch, and BOOM counters with a nice little uppercut knocking you down.  You lose conciousness as you see Madman Mercer walking toward you.

    *** You have died ***

Would you like to RESTART, RESTORE a saved game, QUIT, or UNDO the last command?

>undo
Cultural Plaza
[Previous turn undone.]

>kill dominuse
You can't see any such thing.

>x madman mercer
A white guy about 5 foot 7 inches with curly brown hair wearing a hockey mask.  He is holding a machete.

Madman Mercer walks to another room.

>pick up machete
You can't see any such thing.

>steal machete
That's not a verb I recognise.

>w
Restaurant
A nice little Chinese restaurant where you can smell all of the Char-Siu Buns.

You can see Reflector and a char-siu bau (closed) here.

>x reflector
You see nothing special about Reflector.

>take reflector
Taken.

>x char-siu bau
an amazing delicacy that make you mouth drool.  You really want to eat it.

>pick up char-siu bau
Taken.

>e
Cultural Plaza
The outside of all the stores around you.

>eat char-siu bau
you start eating the char-siu bau, and suddenly you bite something hard.  You see that it is a wooden key.

>x key
a well crafted wooden key to unlock wooden things.

>i
You are carrying:
  wooden key
  Reflector

>n
Stage
A large stage used for lion dance shows, and many other performances.

You can see fancy key here.

>x safe
a very fancy and expensive looking safe.  I would rather steal the safe than what's inside.

>steal safe
That's not a verb I recognise.

>pick up safe
That's hardly portable.

>pick up key
(fancy key)
Taken.

>use key
That's not a verb I recognise.

>unlock safe
What do you want to unlock the fancy safe with?

>key
Which do you mean, fancy key or wooden key?

>fancy key
You unlock the fancy safe.

>open
What do you want to open?

>safe
you see a perfume scented ripped paper.

>pick up paper
You can't see any such thing.

>pick up ripped paper
You can't see any such thing.

>pick up perfume scented ripped paper
You can't see any such thing.

>x paper
You can't see any such thing.

>kill madman mercer
You can't see any such thing.

>s
Cultural Plaza
The outside of all the stores around you.

>ne
Furniture Store
Lots of furniture clutter the store.

You can see shutter and green key here.

>take key
(green key)
Taken.

Madman Mercer walks to another room.

>x shutter
You see nothing special about shutter.

>x safe
You can't see any such thing.

>unlock shutter
What do you want to unlock shutter with?

>key
Which do you mean, green key, fancy key, or wooden key?

>green key
That doesn't seem to be something you can unlock.

>sw
Cultural Plaza
The outside of all the stores around you.

>s
Downtown
A street lighted with street light.

You can see an Instruction Manual here.

>pick up instruction manual
Taken.

>x manual
How to Build a Film Projector for Dummies:

Steps:

*note: must combine in this order

1. Combine Light Source with Reflector

2. Combine Light Source + Reflector Thing with Condenser Lens

3. Combine Light Source + Reflector + Condenser Lens Thing with Imaging Lens

4. Combine Light Source + Reflector + Condenser Lens + Imaging Lens Thing with Shutter

5. Combine Light Source + Reflector + Condenser Lens + Imaging Lens + Shutter Thing with Viewing Screen

6. After combining you should have a Film Projector

7. Find Film

>e
Fruit Stands
Many different containers of fruit are on the stands.

You can see a basket of fruit (in which is Flashlight) here.

>pick up flashlight
taken

>w
Downtown
A street lighted with street light.

You can see Madman Mercer here.

Madman Mercer walks to another room.

>e
Fruit Stands
Many different containers of fruit are on the stands.

You can see a basket of fruit (empty) here.

>w
Downtown
A street lighted with street light.

>se
You can't go that way.

>n
Cultural Plaza
The outside of all the stores around you.

You can see Madman Mercer here.

Madman Mercer walks to another room.

>se
Bathroom
A stinky smelling bathroom.

You can see Imaging Lens and beautiful key here.

>take lens
Taken.

Madman Mercer walks to another room.

>take key
(beautiful key)
Taken.

>x safe
a safe stained with the smell of poop and pee.

>unlock safe
What do you want to unlock the smelly safe with?

>beautiful key
That doesn't seem to fit the lock.

>nw
Cultural Plaza
The outside of all the stores around you.

You can see Madman Mercer here.

Madman Mercer walks to another room.

>ne
Furniture Store
Lots of furniture clutter the store.

You can see shutter here.

>open shutter
That's not something you can open.

>pick up shutter
Taken.

>se
You can't go that way.

>sw
Cultural Plaza
The outside of all the stores around you.

>s
Downtown
A street lighted with street light.

>n
Cultural Plaza
The outside of all the stores around you.

>e
Video Store
A rental video shop, with stands and stands of videos.

You can see Viewing Screen and titanium key here.

>pick up viewing screen
Taken.

>pick up key
(titanium key)
Taken.

>w
Cultural Plaza
The outside of all the stores around you.

You can see Madman Mercer here.

Madman Mercer walks to another room.

>e
Video Store
A rental video shop, with stands and stands of videos.

>w
Cultural Plaza
The outside of all the stores around you.

>s
Downtown
A street lighted with street light.

* * *

>n
Cultural Plaza
The outside of all the stores around you.

>i
You are carrying:
  titanium key
  Viewing Screen
  shutter
  beautiful key
  Imaging Lens
  Flashlight (providing light)
  an Instruction Manual
  green key
  fancy key
  wooden key
  Reflector

>x manual
How to Build a Film Projector for Dummies:

Steps:

*note: must combine in this order

1. Combine Light Source with Reflector

2. Combine Light Source + Reflector Thing with Condenser Lens

3. Combine Light Source + Reflector + Condenser Lens Thing with Imaging Lens

4. Combine Light Source + Reflector + Condenser Lens + Imaging Lens Thing with Shutter

5. Combine Light Source + Reflector + Condenser Lens + Imaging Lens + Shutter Thing with Viewing Screen

6. After combining you should have a Film Projector

7. Find Film

>s
Downtown
A street lighted with street light.

* * *

>n
Cultural Plaza
The outside of all the stores around you.

>n
Stage
A large stage used for lion dance shows, and many other performances.

>s
Cultural Plaza
The outside of all the stores around you.

>ne
Furniture Store
Lots of furniture clutter the store.

>sw
Cultural Plaza
The outside of all the stores around you.

>sw
Convenience Store
There are many snack sold here.

You can see Condenser Lens here.

>pick up lens
(Condenser Lens)
Taken.

>ne
Cultural Plaza
The outside of all the stores around you.

>ne
Furniture Store
Lots of furniture clutter the store.

* * *

>sw
Cultural Plaza
The outside of all the stores around you.

>w
Restaurant
A nice little Chinese restaurant where you can smell all of the Char-Siu Buns.

>buy bun
You can't see any such thing.

>w
You can't go that way.

>e
Cultural Plaza
The outside of all the stores around you.

>s
Downtown
A street lighted with street light.

>e
Fruit Stands
Many different containers of fruit are on the stands.

You can see a basket of fruit (empty) here.

* * *

>w
Downtown
A street lighted with street light.

>w
Fish Market
Fishy smelling market where you can hear the loud clerk yelling "Come get yo ninety nine sense feesh".

>e
Downtown
A street lighted with street light.

>s
You can't go that way.

>x dial
You can't see any such thing.

>x safe
You can't see any such thing.

>unlock safe
You can't see any such thing.

>1384
That's not a verb I recognise.

>spin 1384
You can't see any such thing.

>spin dial
You can't see any such thing.

>spin safe
You can't see any such thing.

>spin number
You can't see any such thing.

>enter dial
You can't see any such thing.

>kill madman mercer
You can't see any such thing.

>spin safe to 1184
You can't see any such thing.

>spin safe to 1384
You can't see any such thing.

>open safe
You can't see any such thing.

>1134
That's not a verb I recognise.

>spin safe to 1134
You can't see any such thing.

>n
Cultural Plaza
The outside of all the stores around you.

* * *

>n
Stage
A large stage used for lion dance shows, and many other performances.

>n
Vault
Snug yet paranoid, this represents the state of the art in cheerless security.

A mammoth safe, with a dial which can spin to any number, has pride of place. It must weigh about the same as a small car, so don't get any ideas.

>s
Stage
A large stage used for lion dance shows, and many other performances.

>n
Vault
Snug yet paranoid, this represents the state of the art in cheerless security.

A mammoth safe, with a dial which can spin to any number, has pride of place. It must weigh about the same as a small car, so don't get any ideas.

* * *

>s
Stage
A large stage used for lion dance shows, and many other performances.

>e
You can't go that way.

>w
You can't go that way.

>w
You can't go that way.

>e
You can't go that way.

>ne
You can't go that way.

>sw
You can't go that way.

>nw
You can't go that way.

>pick up light source
You can't see any such thing.

>take hair
You can't see any such thing.

>take scissor
You can't see any such thing.

>x manual
How to Build a Film Projector for Dummies:

Steps:

*note: must combine in this order

1. Combine Light Source with Reflector

2. Combine Light Source + Reflector Thing with Condenser Lens

3. Combine Light Source + Reflector + Condenser Lens Thing with Imaging Lens

4. Combine Light Source + Reflector + Condenser Lens + Imaging Lens Thing with Shutter

5. Combine Light Source + Reflector + Condenser Lens + Imaging Lens + Shutter Thing with Viewing Screen

6. After combining you should have a Film Projector

7. Find Film

>combine light source with reflector
You can't see any such thing.

>combine with condenser lens
You can't see any such thing.

>combine light source + reflector thing with condenser lens
You can't see any such thing.

>combine light source with condenser lens
You can't see any such thing.

>combine light source with imaging lens
You can't see any such thing.

>combine light source with shutter
You can't see any such thing.

>combine light source with viewing screen
You can't see any such thing.

>i
You are carrying:
  Condenser Lens
  titanium key
  Viewing Screen
  shutter
  beautiful key
  Imaging Lens
  Flashlight (providing light)
  an Instruction Manual
  green key
  fancy key
  wooden key
  Reflector

>w
You can't go that way.

>se
You can't go that way.

>se
You can't go that way.

>x safe
a very fancy and expensive looking safe.  I would rather steal the safe than what's inside.

>unlock safe
What do you want to unlock the fancy safe with?

>hair
You can't see any such thing.

>i
You are carrying:
  Condenser Lens
  titanium key
  Viewing Screen
  shutter
  beautiful key
  Imaging Lens
  Flashlight (providing light)
  an Instruction Manual
  green key
  fancy key
  wooden key
  Reflector

* * *

>go n
Stage
A large stage used for lion dance shows, and many other performances.

You can see fancy key here.

>go n
Vault
Snug yet eery room that gives you the heeby jeebies.

A mammoth metal box, with a dial which can spin to any number.  It looks as hard as diamond, so don't get any ideas.

You can also see Madman Mercer here.

Madman Mercer walks to another room.

>spin dial to 1384
Clonk! and the metal door swings slowly open, revealing Film.

>go s
Stage
A large stage used for lion dance shows, and many other performances.

You can see Madman Mercer and fancy key here.

Madman Mercer walks to another room.

>go s
Cultural Plaza
The outside of all the stores around you.

>go se
you have the urge to POOP
Bathroom
A stinky smelling bathroom.

You can see Imaging Lens, beautiful key, and a toilet (empty) here.

>poop in toilet
Madman Mercer walks to another room.

>pooping in toilet
That's not a verb I recognise.

>poo
That's not a verb I recognise.

>poop
What do you want to poop in?

>toilel
You can't see any such thing.

>poop
What do you want to poop in?

* * *

>pooping
That's not a verb I recognise.

>poop
What do you want to poop in?

>in toilet
I only understood you as far as wanting to poop in inside.

>poop
What do you want to poop in?

* * *

I beg your pardon?

>i
You are carrying nothing.

* * *

>go n
Stage
A large stage used for lion dance shows, and many other performances.

You can see fancy key here.

>go e
Please give one of the answers above.

Would you like to RESTART, RESTORE a saved game, QUIT, or UNDO the last command?

>go s
Please give one of the answers above.

Would you like to RESTART, RESTORE a saved game, QUIT, or UNDO the last command?

>go s
Please give one of the answers above.

Would you like to RESTART, RESTORE a saved game, QUIT, or UNDO the last command?