You go out with your friends to watch the latest horror movie called "Madman Mercer."  In the movie you see Madman Mercer chasing people through Chinatown in the middle of the night with a machete.  As you are watching you suddenly fall asleep.  When you wake up you are on the cold damp ground of Chinatown.  You can hear the high speed swings of a machete.  In your mind you think "Oh no". 
Escape the Movie
An Interactive Fiction by Dylan Zhang
Release 1 / Serial number 131018 / Inform 7 build 6G60 (I6/v6.32 lib 6/12N) SD

Cultural Plaza
The center of this nice little mall with stores surrounding you, and bushes decorating the outside.  It is outdoors and deserted.  No one is sitting on the benches like they usually do.
  
There is a nice little directory here too, showing all the stores.

You can see a worn out book and an Instruction Manual here.

>x book
It seems like Madman Mercer dropped this book.  The cover says DO NOT READ: Property of Madman Mercer.
Maybe you should try opening the book and reading it.

>open book
You open the book. 
 
The first page says:
 My Plan:
 -Find the magical Film that opens up a dimensional gate to reality
 -Escape the horror movie
 -Proceed to kill everyone in the real world
 -Build Film Projector to play film 
 -Find the papers that contain the combination of numbers to get the film 
 
 The rest of the pages are Madman Mercer writing about how his life sucks.

Maybe you should find the pages and build to projector to escape back to your world
You are safe from Madman Mercer for now.

>undo
Cultural Plaza
[Previous turn undone.]

>read book
It seems like Madman Mercer dropped this book.  The cover says DO NOT READ: Property of Madman Mercer.
Maybe you should try opening the book and reading it.

You are safe from Madman Mercer for now.

>read book
It seems like Madman Mercer dropped this book.  The cover says DO NOT READ: Property of Madman Mercer.
Maybe you should try opening the book and reading it.

You are safe from Madman Mercer for now.

>open book
You open the book. 
 
The first page says:
 My Plan:
 -Find the magical Film that opens up a dimensional gate to reality
 -Escape the horror movie
 -Proceed to kill everyone in the real world
 -Build Film Projector to play film 
 -Find the papers that contain the combination of numbers to get the film 
 
 The rest of the pages are Madman Mercer writing about how his life sucks.

Maybe you should find the pages and build to projector to escape back to your world
You hear the speedy swings of the machete cutting the air.
You can hear the loud heavy footsteps from the Madman Mercer as he walks into the room,  I would recommend not staying too long in this room.

Madman Mercer looks into your soul with his blood shot eyes running at you.  I wouldn't be in his line of sight for too long if i were you.

>n
Stage
A large stage used for lion dance shows, Kung Fu performance, and many other performances or events.  There is a red door leading to the backstage.  The exit to Cultural Plaza is to the south.

You can see a red door and fancy key here.

Madman Mercer looks into your soul with his blood shot eyes running at you.  I wouldn't be in his line of sight for too long if i were you.

>s
Cultural Plaza
The center of this nice little mall with stores surrounding you, and bushes decorating the outside.  It is outdoors and deserted.  No one is sitting on the benches like they usually do.
  
There is a nice little directory here too, showing all the stores.

You can see a worn out book and an Instruction Manual here.

You hear the speedy swings of the machete cutting the air.

Madman Mercer looks into your soul with his blood shot eyes running at you.  I wouldn't be in his line of sight for too long if i were you.

>nw
Hair Salon
A hair salon with little pieces of hair on the floor everywhere.  You see a beautiful safe.  The exit to Cultural Plaza is to the southeast.

Madman Mercer looks into your soul with his blood shot eyes running at you.  I wouldn't be in his line of sight for too long if i were you.

I beg your pardon?

* * *

>talk to madman mercer
Madman Mercer doesn't reply.

Madman Mercer walks to another room.

>n
Stage
A large stage used for lion dance shows, Kung Fu performance, and many other performances or events.  There is a nice big curtain at the back of the stage to conceal the backstage of performers and props.

You can see a red door and fancy key here.

* * *

>s
Fish Market
Fishy smelling market where you can hear the clueless chinese fisherman who is unaware of Madman Mercer, yelling in his accent "Come get yo ninety nine sense fish.  Veeery cheap fish.".  The exit to Cultural Plaza is to the north.

You can see Reflector and a chinese fisherman here.

You are safe from Madman Mercer for now.

>s
You can't go that way.

You are safe from Madman Mercer for now.

>n
Cultural Plaza
The center of this nice little mall with stores surrounding you, and bushes decorating the outside.  It is outdoors and deserted.  No one is sitting on the benches like they usually do.
  
There is a nice little directory here too, showing all the stores.

You can see a worn out book and an Instruction Manual here.

You are safe from Madman Mercer for now.

>n
Stage
A large stage used for lion dance shows, Kung Fu performance, and many other performances or events.  There is a red door leading to the backstage.  The exit to Cultural Plaza is to the south.

You can see a red door and fancy key here.

You are safe from Madman Mercer for now.

>s
Cultural Plaza
The center of this nice little mall with stores surrounding you, and bushes decorating the outside.  It is outdoors and deserted.  No one is sitting on the benches like they usually do.
  
There is a nice little directory here too, showing all the stores.

You can see a worn out book and an Instruction Manual here.

You are safe from Madman Mercer for now.

>s
Fish Market
Fishy smelling market where you can hear the clueless chinese fisherman who is unaware of Madman Mercer, yelling in his accent "Come get yo ninety nine sense fish.  Veeery cheap fish.".  The exit to Cultural Plaza is to the north.

You can see Reflector and a chinese fisherman here.

You are safe from Madman Mercer for now.

>n
Cultural Plaza
The center of this nice little mall with stores surrounding you, and bushes decorating the outside.  It is outdoors and deserted.  No one is sitting on the benches like they usually do.
  
There is a nice little directory here too, showing all the stores.

You can see a worn out book and an Instruction Manual here.

You are safe from Madman Mercer for now.

* * *

>s
Cultural Plaza
The center of this nice little mall with stores surrounding you, and bushes decorating the outside.  It is outdoors and deserted.  No one is sitting on the benches like they usually do.
  
There is a nice little directory here too, showing all the stores.

You can see a worn out book and an Instruction Manual here.

You are safe from Madman Mercer for now.

>s
Fish Market
Fishy smelling market where you can hear the clueless chinese fisherman who is unaware of Madman Mercer, yelling in his accent "Come get yo ninety nine sense fish.  Veeery cheap fish.".  The exit to Cultural Plaza is to the north.

You can see Reflector and a chinese fisherman here.

You hear the speedy swings of the machete cutting the air.
You can hear the loud heavy footsteps from the Madman Mercer as he walks into the room,  I would recommend not staying too long in this room.

Madman Mercer looks into your soul with his blood shot eyes running at you.  I wouldn't be in his line of sight for too long if i were you.

>n
Cultural Plaza
The center of this nice little mall with stores surrounding you, and bushes decorating the outside.  It is outdoors and deserted.  No one is sitting on the benches like they usually do.
  
There is a nice little directory here too, showing all the stores.

You can see a worn out book and an Instruction Manual here.

Madman Mercer looks into your soul with his blood shot eyes running at you.  I wouldn't be in his line of sight for too long if i were you.

>n
Stage
A large stage used for lion dance shows, Kung Fu performance, and many other performances or events.  There is a red door leading to the backstage.  The exit to Cultural Plaza is to the south.

You can see a red door and fancy key here.

Madman Mercer looks into your soul with his blood shot eyes running at you.  I wouldn't be in his line of sight for too long if i were you.

>s
Cultural Plaza
The center of this nice little mall with stores surrounding you, and bushes decorating the outside.  It is outdoors and deserted.  No one is sitting on the benches like they usually do.
  
There is a nice little directory here too, showing all the stores.

You can see a worn out book and an Instruction Manual here.

Madman Mercer looks into your soul with his blood shot eyes running at you.  I wouldn't be in his line of sight for too long if i were you.

>n
Stage
A large stage used for lion dance shows, Kung Fu performance, and many other performances or events.  There is a red door leading to the backstage.  The exit to Cultural Plaza is to the south.

You can see a red door and fancy key here.

Madman Mercer looks into your soul with his blood shot eyes running at you.  I wouldn't be in his line of sight for too long if i were you.

>s
Cultural Plaza
The center of this nice little mall with stores surrounding you, and bushes decorating the outside.  It is outdoors and deserted.  No one is sitting on the benches like they usually do.
  
There is a nice little directory here too, showing all the stores.

You can see a worn out book and an Instruction Manual here.

Madman Mercer looks into your soul with his blood shot eyes running at you.  I wouldn't be in his line of sight for too long if i were you.

    *** You have died ***

Would you like to RESTART, RESTORE a saved game, QUIT, or UNDO the last command?

>n
Please give one of the answers above.

Would you like to RESTART, RESTORE a saved game, QUIT, or UNDO the last command?

>s
Please give one of the answers above.

Would you like to RESTART, RESTORE a saved game, QUIT, or UNDO the last command?

>n
Please give one of the answers above.

Would you like to RESTART, RESTORE a saved game, QUIT, or UNDO the last command?

>n
Please give one of the answers above.

Would you like to RESTART, RESTORE a saved game, QUIT, or UNDO the last command?

* * *

>s
Please give one of the answers above.

Would you like to RESTART, RESTORE a saved game, QUIT, or UNDO the last command?

>s
Please give one of the answers above.

Would you like to RESTART, RESTORE a saved game, QUIT, or UNDO the last command?

* * *

>x manual
How to Build a Film Projector for Dummies:

Steps:

*note: must combine in this order

1. Combine flashlight with Reflector

2. Combine flashlight Reflector Thing with Condenser Lens

3. Combine flashlight Reflector Condenser Lens Thing with Imaging Lens

4. Combine flashlight Reflector Condenser Lens Imaging Lens Thing with Shutter

5. Combine flashlight Reflector Condenser Lens Imaging Lens Shutter Thing with Viewing Screen

6. After combining you should have a Film Projector

7. Find Film

Madman Mercer walks to another room.

>talk to mercer
I wouldn't do that if I were you, he might rage so hard on you and kill you.

Madman Mercer walks to another room.

>talk to madman mercer
You can't see any such thing.

>n
Stage
A large stage used for lion dance shows, Kung Fu performance, and many other performances or events.  There is a red door leading to the backstage.

You can see a red door, Madman Mercer, and fancy key here.

Madman Mercer walks to another room.

>x key
an expensive looking key that looks like it unlocks expensive things.

>take key
Taken.

>open red door
It seems to be locked.

Madman Mercer walks to another room.

>unlock red door
(with fancy key)
That doesn't seem to fit the lock.

>ne
You can't go that way.

>north east
I only understood you as far as wanting to north.

>northeast
You can't go that way.

>nw
You can't go that way.

Madman Mercer walks to another room.

>w
You can't go that way.

>n
(first opening the red door)
It seems to be locked.

>s
Cultural Plaza
The center of this nice little mall with stores surrounding you.  It is outdoors and deserted unlike how lively it usually is, with the old chinese folk sitting on the benches outside by the bushes playing there violin, and the many old chinese folk slowly moving there bodies in an intense session of Tai-Chi.  There are exits to the north, northeast, northwest, west, east, south, southeast, and southwest.

You can see an Instruction Manual here.

>northeast
Furniture Store
Lots of furniture clutter the store.

You can see a couch and shutter here.

>talk to madman mercer
You can't see any such thing.

>x couche
You can't see any such thing.

>x couch
A nice big light brown leather couch.  Lots of people come and sit on it everday, and maybe you can search the couch to see if anything fell out of their pockets in between the couch cushions

>search couch
You search the gaps in the couch cushions. 
You find a crumpled paper.

>x paper
spin dial 1384

>take paper
You already have that.

>x shutter
You recognize the shutter as a shutter from one of those projectors you saw at the movie theater.

>take shutter
Taken.

>sw
Cultural Plaza
The center of this nice little mall with stores surrounding you.  It is outdoors and deserted unlike how lively it usually is, with the old chinese folk sitting on the benches outside by the bushes playing there violin, and the many old chinese folk slowly moving there bodies in an intense session of Tai-Chi.  There are exits to the north, northeast, northwest, west, east, south, southeast, and southwest.

You can see an Instruction Manual here.

>nw
Hair Salon
A hair salon with little pieces of hair on the floor everywhere.  You see a beautiful safe.

You can see a pair of scissors and a wad of hair (closed) here.

>x safe
A beautiful safe that has a keyhole that look like a beautiful key goes in.

>x scissors
very sharp scissors able to cut through even the strongest hairs.

>take scissors
Taken.

>take all
Think again big boy.

>take wad of hair
Taken.

>x hair
A wad of hair leftover from someone's haircut.

>open safe
you see a small ripped paper.

>x paper
spin dial 1384

>spin dial 1384
You can't see any such thing.

>unlock sasfe
You can't see any such thing.

>unlock safe
What do you want to unlock the beautiful safe with?

>spin dial
You can't see any such thing.

>take paper
You already have that.

>se
Cultural Plaza
The center of this nice little mall with stores surrounding you.  It is outdoors and deserted unlike how lively it usually is, with the old chinese folk sitting on the benches outside by the bushes playing there violin, and the many old chinese folk slowly moving there bodies in an intense session of Tai-Chi.  There are exits to the north, northeast, northwest, west, east, south, southeast, and southwest.

You can see an Instruction Manual here.

>w
Fruit store
Many different baskets of fruit fill the store.

You can see green basket (in which is pears), pink basket (in which is peaches), and a red basket (in which is Apples) here.

>x madman mercer
You can't see any such thing.

>x green basket
many green pears fill the basket.

In green basket is pears.

>take pears
Taken.

>take all
Think again big boy.

>take pink basket
Taken.

>take red basket
Taken.

>i
You are carrying:
  a red basket (open)
    Apples
  pink basket (open)
    peaches
  pears
  a wad of hair (closed and locked)
  a pair of scissors
  shutter
  crumpled paper
  fancy key

>e
Cultural Plaza
The center of this nice little mall with stores surrounding you.  It is outdoors and deserted unlike how lively it usually is, with the old chinese folk sitting on the benches outside by the bushes playing there violin, and the many old chinese folk slowly moving there bodies in an intense session of Tai-Chi.  There are exits to the north, northeast, northwest, west, east, south, southeast, and southwest.

You can see an Instruction Manual here.

>e
video store
A rental video shop, with stands and stands of videos.

You can see a red key and Viewing Screen here.

>take red key
Taken.

>x viewing screen
A big screen used to project movies on.

>take screen
Taken.

>x key
Which do you mean, the red key or fancy key?

>red
A brass key that was painted red, so that people knew what kind of door it unlocked.

>w
Cultural Plaza
The center of this nice little mall with stores surrounding you.  It is outdoors and deserted unlike how lively it usually is, with the old chinese folk sitting on the benches outside by the bushes playing there violin, and the many old chinese folk slowly moving there bodies in an intense session of Tai-Chi.  There are exits to the north, northeast, northwest, west, east, south, southeast, and southwest.

You can see an Instruction Manual here.

>se
Bathroom
A stinky smelling bathroom.  Urinals lining the wall and unflushed toilets fill the bathroom.

You can see Imaging Lens, beautiful key, and a toilet (in which is poop) here.

you have the urge to POOP

>poop
What do you want to poop in?

>toilet
Plop! brown things come from your butt into the toilet.  I recommend you flush it before it stinks up the place.

>x lens
You recognize the lens as the part projector of a projector that produces images.

>take lens
Taken.

>take beautiful key
Taken.

>take toilet
That's fixed in place.

>nw
Cultural Plaza
The center of this nice little mall with stores surrounding you.  It is outdoors and deserted unlike how lively it usually is, with the old chinese folk sitting on the benches outside by the bushes playing there violin, and the many old chinese folk slowly moving there bodies in an intense session of Tai-Chi.  There are exits to the north, northeast, northwest, west, east, south, southeast, and southwest.

You can see an Instruction Manual here.

>talk to madman mercer
You can't see any such thing.

>nw
Hair Salon
A hair salon with little pieces of hair on the floor everywhere.  You see a beautiful safe.

>unlock safe
What do you want to unlock the beautiful safe with?

>beautiful key
You unlock the beautiful safe.

>open safe
you see a small ripped paper.

>x ripper paper
You can't see any such thing.

I beg your pardon?

>kill madman mercer
You can't see any such thing.

>kill dominuse
You can't see any such thing.

>go to madman mercer
You can't see any such thing.

>take paper
You already have that.

>i
You are carrying:
  beautiful key
  Imaging Lens
  Viewing Screen
  a red key
  a red basket (open)
    Apples
  pink basket (open)
    peaches
  pears
  a wad of hair (closed and locked)
  a pair of scissors
  shutter
  crumpled paper
  fancy key

>take ripped paper
You can't see any such thing.

>kill everyone
You can't see any such thing.

>kill self
Violence isn't the answer to this one.

>look at self
You are a boy named Dominuse, who is asian.  You are wearing shorts and a t-shirt.  You are a pretty tick guy.

* * *

>kill madman
No one is stopping, but I wouldn't try to kill him because he is armed and dangerous.

Madman Mercer walks to another room.

* * *

>x instruction manual
How to Build a Film Projector for Dummies:

Steps:

*note: must combine in this order

1. Combine flashlight with Reflector

2. Combine flashlight Reflector Thing with Condenser Lens

3. Combine flashlight Reflector Condenser Lens Thing with Imaging Lens

4. Combine flashlight Reflector Condenser Lens Imaging Lens Thing with Shutter

5. Combine flashlight Reflector Condenser Lens Imaging Lens Shutter Thing with Viewing Screen

6. After combining you should have a Film Projector

7. Find Film

Madman Mercer walks to another room.

>take manual
Taken.

>l
Cultural Plaza
The center of this nice little mall with stores surrounding you.  It is outdoors and deserted unlike how lively it usually is, with the old chinese folk sitting on the benches outside by the bushes playing there violin, and the many old chinese folk slowly moving there bodies in an intense session of Tai-Chi.  There are exits to the north, northeast, northwest, west, east, south, southeast, and southwest.

>x stores
You look to the north and see the great, big stage.  You look northwest and see a nice little hair salon.  You look to the west and see a nice place to eat dim-sum.  You look southwest and see a convenience store.   You look northeast and see a furniture store.  You look east and see a rental video store.  You look southeast and see the bathrooms.

>s
Fish Market
Fishy smelling market where you can hear the loud chinese fisherman yelling in his accent "Come get yo ninety nine sense feesh.  Veeery cheap fish.".

You can see Reflector and a chinese fisherman here.

>take reflector
Taken.

>talk to fisherman
The chinese fisherman doesn't reply.

>kick fisherman
That's not a verb I recognise.

>attack fisherman
Violence isn't the answer to this one.

>n
Cultural Plaza
The center of this nice little mall with stores surrounding you.  It is outdoors and deserted unlike how lively it usually is, with the old chinese folk sitting on the benches outside by the bushes playing there violin, and the many old chinese folk slowly moving there bodies in an intense session of Tai-Chi.  There are exits to the north, northeast, northwest, west, east, south, southeast, and southwest.

You can see Madman Mercer here.

Madman Mercer walks to another room.

>i
You are carrying:
  Reflector
  an Instruction Manual

>x manual
How to Build a Film Projector for Dummies:

Steps:

*note: must combine in this order

1. Combine flashlight with Reflector

2. Combine flashlight Reflector Thing with Condenser Lens

3. Combine flashlight Reflector Condenser Lens Thing with Imaging Lens

4. Combine flashlight Reflector Condenser Lens Imaging Lens Thing with Shutter

5. Combine flashlight Reflector Condenser Lens Imaging Lens Shutter Thing with Viewing Screen

6. After combining you should have a Film Projector

7. Find Film

>se
Bathroom
A stinky smelling bathroom.  Urinals lining the wall and unflushed toilets fill the bathroom.

You can see Imaging Lens, beautiful key, and a toilet (in which is poop) here.

you have the urge to POOP

>x lens
You recognize the lens as the part projector of a projector that produces images.

* * *

>take lens
Taken.

>i
You are carrying:
  Imaging Lens
  Reflector
  an Instruction Manual

>x reflector
A light reflecting mirror.  It seems to be a part of some kind of machine.

>take key
Taken.

>poop
What do you want to poop in?

* * *

>toilet
Plop! brown things come from your butt into the toilet.  I recommend you flush it before it stinks up the place.

>flush
What do you want to flush?

>toilet
the toilet clogs and a soggy scrap of paper appears!

>take paper
Taken.

>x paper
1384

>nw
Cultural Plaza
The center of this nice little mall with stores surrounding you.  It is outdoors and deserted unlike how lively it usually is, with the old chinese folk sitting on the benches outside by the bushes playing there violin, and the many old chinese folk slowly moving there bodies in an intense session of Tai-Chi.  There are exits to the north, northeast, northwest, west, east, south, southeast, and southwest.

You can see Madman Mercer here.

Madman Mercer walks to another room.

>sw
Darkness
It is pitch dark, and you can't see a thing.

>ne
Cultural Plaza
The center of this nice little mall with stores surrounding you.  It is outdoors and deserted unlike how lively it usually is, with the old chinese folk sitting on the benches outside by the bushes playing there violin, and the many old chinese folk slowly moving there bodies in an intense session of Tai-Chi.  There are exits to the north, northeast, northwest, west, east, south, southeast, and southwest.

>e
video store
A rental video shop, with stands and stands of videos.

You can see a red key and Viewing Screen here.

* * *

>take red key
Taken.

>x red key
A brass key that was painted red, so that people knew what kind of door it unlocked.

Madman Mercer walks to another room.

>x beautiful key
a beautiful key that unlocks beautiful things.

>x viewing screen
A big screen used to project movies on.

* * *

>take screen
Taken.

>i
You are carrying:
  Viewing Screen
  a red key
  soggy scrap of paper
  beautiful key
  Imaging Lens
  Reflector
  an Instruction Manual

>x instruction manual
How to Build a Film Projector for Dummies:

Steps:

*note: must combine in this order

1. Combine flashlight with Reflector

2. Combine flashlight Reflector Thing with Condenser Lens

3. Combine flashlight Reflector Condenser Lens Thing with Imaging Lens

4. Combine flashlight Reflector Condenser Lens Imaging Lens Thing with Shutter

5. Combine flashlight Reflector Condenser Lens Imaging Lens Shutter Thing with Viewing Screen

6. After combining you should have a Film Projector

7. Find Film

>w
Cultural Plaza
The center of this nice little mall with stores surrounding you.  It is outdoors and deserted unlike how lively it usually is, with the old chinese folk sitting on the benches outside by the bushes playing there violin, and the many old chinese folk slowly moving there bodies in an intense session of Tai-Chi.  There are exits to the north, northeast, northwest, west, east, south, southeast, and southwest.

>ne
Furniture Store
Lots of furniture clutter the store.

You can see a couch and shutter here.

>x couch
A nice big light brown leather couch.  Lots of people come and sit on it everday, and maybe you can search the couch to see if anything fell out of their pockets in between the couch cushions

* * *

>search couch
You search the gaps in the couch cushions. 
You find a crumpled paper.

>x paper
Which do you mean, crumpled paper or soggy scrap of paper?

>crumpled paper
MCCCLXXXIV

>take paper
Which do you mean, crumpled paper or soggy scrap of paper?

>crumpled
You already have that.

>uncrumple paper
That's not a verb I recognise.

>mccclxxxiv
That's not a verb I recognise.

>l
Furniture Store
Lots of furniture clutter the store.

You can see a couch and shutter here.

>x shutter
You recognize the shutter as a shutter from one of those projectors you saw at the movie theater.

* * *

>take shutter
Taken.

>l
Furniture Store
Lots of furniture clutter the store.

You can see a couch here.

>i
You are carrying:
  shutter
  crumpled paper
  Viewing Screen
  a red key
  soggy scrap of paper
  beautiful key
  Imaging Lens
  Reflector
  an Instruction Manual

>x instruction manual
How to Build a Film Projector for Dummies:

Steps:

*note: must combine in this order

1. Combine flashlight with Reflector

2. Combine flashlight Reflector Thing with Condenser Lens

3. Combine flashlight Reflector Condenser Lens Thing with Imaging Lens

4. Combine flashlight Reflector Condenser Lens Imaging Lens Thing with Shutter

5. Combine flashlight Reflector Condenser Lens Imaging Lens Shutter Thing with Viewing Screen

6. After combining you should have a Film Projector

7. Find Film

>sw
Cultural Plaza
The center of this nice little mall with stores surrounding you.  It is outdoors and deserted unlike how lively it usually is, with the old chinese folk sitting on the benches outside by the bushes playing there violin, and the many old chinese folk slowly moving there bodies in an intense session of Tai-Chi.  There are exits to the north, northeast, northwest, west, east, south, southeast, and southwest.

>n
Stage
A large stage used for lion dance shows, Kung Fu performance, and many other performances or events.  There is a nice big curtain at the back of the stage to conceal the backstage of performers and props.

You can see a red door and fancy key here.

>x stage
You can't see any such thing.

>x curtain
You can't see any such thing.

>x red door
A red door that is red because that is the lucky chinese color.

>unlock red door with red key
You unlock the red door.

>x fancy key
an expensive looking key that looks like it unlocks expensive things.

Madman Mercer walks to another room.

>take key
(fancy key)
Taken.

>n
(first opening the red door)

Backstage
A strange room that you wouldn't have guessed to be behind the stage of Cultual Plaza.  The room surrounds you with metal walls and a very bright light, like the ones they use in surgeries hanging from the ceiling.

A metal box the size of and Xbox 360, that has a dial which can spin to any number on the front.  It looks very solid, so I wouldn't waste your energy on trying force it open.

You can also see a red door here.

>i
You are carrying:
  fancy key
  shutter
  crumpled paper
  Viewing Screen
  a red key
  soggy scrap of paper
  beautiful key
  Imaging Lens
  Reflector
  an Instruction Manual

>x crumpled paper
MCCCLXXXIV

>x soggy paper
1384

>1384
That's not a verb I recognise.

>enter 1384
You can't see any such thing.

>enter 1
You can't see any such thing.

>spin to 1
You can't see any such thing.

>spin dial to 1
Click! and nothing else happens.

>spin dial to 3
Click! and nothing else happens.

>spin dial to 8
Click! and nothing else happens.

>spin dial to 4
Click! and nothing else happens.

>s
Stage
A large stage used for lion dance shows, Kung Fu performance, and many other performances or events.  There is a nice big curtain at the back of the stage to conceal the backstage of performers and props.

You can see a red door here.

>s
Cultural Plaza
The center of this nice little mall with stores surrounding you.  It is outdoors and deserted unlike how lively it usually is, with the old chinese folk sitting on the benches outside by the bushes playing there violin, and the many old chinese folk slowly moving there bodies in an intense session of Tai-Chi.  There are exits to the north, northeast, northwest, west, east, south, southeast, and southwest.

>nw
Hair Salon
A hair salon with little pieces of hair on the floor everywhere.  You see a beautiful safe.

You can see a pair of scissors and a wad of hair (closed) here.

>i
You are carrying:
  fancy key
  shutter
  crumpled paper
  Viewing Screen
  a red key
  soggy scrap of paper
  beautiful key
  Imaging Lens
  Reflector
  an Instruction Manual

>unlock beautiful safe
What do you want to unlock the beautiful safe with?

>key
Which do you mean, fancy key, the red key, or beautiful key?

>beautiful key
You unlock the beautiful safe.

>open
What do you want to open?

>safe
you see a small ripped paper.

>take paper
Which do you mean, crumpled paper or soggy scrap of paper?

>take ripped paper
You can't see any such thing.

>i
You are carrying:
  fancy key
  shutter
  crumpled paper
  Viewing Screen
  a red key
  soggy scrap of paper
  beautiful key
  Imaging Lens
  Reflector
  an Instruction Manual

>l
Hair Salon
A hair salon with little pieces of hair on the floor everywhere.  You see a beautiful safe.

You can see a pair of scissors and a wad of hair (closed) here.

>x beautiful safe
A beautiful safe that has a keyhole that look like a beautiful key goes in.

>i
You are carrying:
  fancy key
  shutter
  crumpled paper
  Viewing Screen
  a red key
  soggy scrap of paper
  beautiful key
  Imaging Lens
  Reflector
  an Instruction Manual

>take small ripped paper
You can't see any such thing.

>take small ripped paper
You can't see any such thing.

>take ripped paper
You can't see any such thing.

>l
Hair Salon
A hair salon with little pieces of hair on the floor everywhere.  You see a beautiful safe.

You can see a pair of scissors and a wad of hair (closed) here.

>take scissors
Taken.

>open hair
It seems to be locked.

>unlock hair
What do you want to unlock the wad of hair with?

>scissors
You unlock the wad of hair.

Madman Mercer walks to another room.

>open hair
You open the wad of hair.

Madman mercer knocks you out, and everything goes black.
Madman Mercer walks to another room.

* * *

>x madman mercer
A white guy about 5 foot 7 inches with curly brown hair wearing a hockey mask.  He is holding a machete.

Madman Mercer walks to another room.

* * *

>talk to madman
I wouldn't do that if I were you, he might rage so hard on you and kill you.

Madman Mercer walks to another room.

>undo
Cultural Plaza
[Previous turn undone.]

>kill madman mercer
Madman Mercer is unphased by your weak punch, and BOOM counters with a nice little uppercut knocking you down.  You lose conciousness as you see Madman Mercer walking toward you.

    *** You have died ***

Would you like to RESTART, RESTORE a saved game, QUIT, or UNDO the last command?

>hax
Please give one of the answers above.

Would you like to RESTART, RESTORE a saved game, QUIT, or UNDO the last command?

>hax
Please give one of the answers above.

Would you like to RESTART, RESTORE a saved game, QUIT, or UNDO the last command?

>stupid
Please give one of the answers above.

Would you like to RESTART, RESTORE a saved game, QUIT, or UNDO the last command?

>dumb
Please give one of the answers above.

Would you like to RESTART, RESTORE a saved game, QUIT, or UNDO the last command?

>screw this game
Please give one of the answers above.

Would you like to RESTART, RESTORE a saved game, QUIT, or UNDO the last command?

>kill yourself
Please give one of the answers above.

Would you like to RESTART, RESTORE a saved game, QUIT, or UNDO the last command?

>RAGE!!!!!!!
Please give one of the answers above.

Would you like to RESTART, RESTORE a saved game, QUIT, or UNDO the last command?

>EFJOANFEOIAMNFEWIOJFWEDIOV[WAEDS
Please give one of the answers above.

Would you like to RESTART, RESTORE a saved game, QUIT, or UNDO the last command?

>\FEWDVIJOhjewadisofenwoipwekms
Please give one of the answers above.

Would you like to RESTART, RESTORE a saved game, QUIT, or UNDO the last command?

* * *

>talk to madman
I wouldn't do that if I were you, he might rage so hard on you and kill you.

Madman Mercer walks to another room.

>go n
Stage
A large stage used for lion dance shows, Kung Fu performance, and many other performances or events.  There is a red door leading to the backstage.

You can see a red door and fancy key here.

>go s
Cultural Plaza
The center of this nice little mall with stores surrounding you, and bushes decorating the outside.  It is outdoors and deserted.  No one sittting on the benches like they usually do.  There is a nice little directory here too showing all the stores.

You can see an Instruction Manual here.

>talk to madman
You can't see any such thing.

>go s
Fish Market
Fishy smelling market where you can hear the clueless chinese fisherman who is unaware of Madman Mercer, yelling in his accent "Come get yo ninety nine sense fish.  Veeery cheap fish.".

You can see Reflector and a chinese fisherman here.

>go n
Cultural Plaza
The center of this nice little mall with stores surrounding you, and bushes decorating the outside.  It is outdoors and deserted.  No one sittting on the benches like they usually do.  There is a nice little directory here too showing all the stores.

You can see an Instruction Manual here.

>go w
Fruit store
Many different baskets of fruit fill the store.

You can see green basket (in which is pears), pink basket (in which is peaches), and a red basket (in which is Apples) here.

>go e
Cultural Plaza
The center of this nice little mall with stores surrounding you, and bushes decorating the outside.  It is outdoors and deserted.  No one sittting on the benches like they usually do.  There is a nice little directory here too showing all the stores.

You can see an Instruction Manual here.

>go
You'll have to say which compass direction to go in.

>e
video store
A rental video shop, with stands and stands of videos.

You can see a red key and Viewing Screen here.

>w
Cultural Plaza
The center of this nice little mall with stores surrounding you, and bushes decorating the outside.  It is outdoors and deserted.  No one sittting on the benches like they usually do.  There is a nice little directory here too showing all the stores.

You can see an Instruction Manual here.

>n
Stage
A large stage used for lion dance shows, Kung Fu performance, and many other performances or events.  There is a red door leading to the backstage.

You can see a red door and fancy key here.

>s
Cultural Plaza
The center of this nice little mall with stores surrounding you, and bushes decorating the outside.  It is outdoors and deserted.  No one sittting on the benches like they usually do.  There is a nice little directory here too showing all the stores.

You can see an Instruction Manual here.

>s
Fish Market
Fishy smelling market where you can hear the clueless chinese fisherman who is unaware of Madman Mercer, yelling in his accent "Come get yo ninety nine sense fish.  Veeery cheap fish.".

You can see Reflector and a chinese fisherman here.

>n
Cultural Plaza
The center of this nice little mall with stores surrounding you, and bushes decorating the outside.  It is outdoors and deserted.  No one sittting on the benches like they usually do.  There is a nice little directory here too showing all the stores.

You can see an Instruction Manual here.

>n
Stage
A large stage used for lion dance shows, Kung Fu performance, and many other performances or events.  There is a red door leading to the backstage.

You can see a red door and fancy key here.

* * *

>s
Cultural Plaza
The center of this nice little mall with stores surrounding you, and bushes decorating the outside.  It is outdoors and deserted.  No one sittting on the benches like they usually do.  There is a nice little directory here too showing all the stores.

You can see an Instruction Manual here.

>e
video store
A rental video shop, with stands and stands of videos.

You can see a red key and Viewing Screen here.

* * *

>w
Cultural Plaza
The center of this nice little mall with stores surrounding you, and bushes decorating the outside.  It is outdoors and deserted.  No one sittting on the benches like they usually do.  There is a nice little directory here too showing all the stores.

You can see an Instruction Manual here.

>kk
That's not a verb I recognise.

>mama zhang
That's not a verb I recognise.

* * *

>go w
Fruit store
Many different baskets of fruit fill the store.

You can see green basket (in which is pears), pink basket (in which is peaches), and a red basket (in which is Apples) here.

>take apples
you take the apples and revealed a flashlight.

>i
You are carrying:
  Apples

>x apples
Big, nice, juicy, red apples.

Madman Mercer walks to another room.

>take flashlight
taken

>take peaches
Taken.

>go e
Cultural Plaza
The center of this nice little mall with stores surrounding you.  It is outdoors and deserted unlike how lively it usually is, with the old chinese folk sitting on the benches outside by the bushes playing there violin, and the many old chinese folk slowly moving there bodies in an intense session of Tai-Chi.

>go e
video store
A rental video shop, with stands and stands of videos.

You can see a red key and Viewing Screen here.

>take viewing screen
Taken.

>go w
Cultural Plaza
The center of this nice little mall with stores surrounding you.  It is outdoors and deserted unlike how lively it usually is, with the old chinese folk sitting on the benches outside by the bushes playing there violin, and the many old chinese folk slowly moving there bodies in an intense session of Tai-Chi.

>go s
Fish Market
Fishy smelling market where you can hear the loud chinese fisherman yelling in his accent "Come get yo ninety nine sense feesh.  Veeery cheap fish.".

You can see Reflector, an Instruction Manual, and a chinese fisherman here.

>take reflector
Taken.

>take manual
Taken.

>go n
Cultural Plaza
The center of this nice little mall with stores surrounding you.  It is outdoors and deserted unlike how lively it usually is, with the old chinese folk sitting on the benches outside by the bushes playing there violin, and the many old chinese folk slowly moving there bodies in an intense session of Tai-Chi.

>go w
Fruit store
Many different baskets of fruit fill the store.

You can see green basket (in which is pears), pink basket (empty), and a red basket (empty) here.

>take apples
You already have that.

>i
You are carrying:
  an Instruction Manual
  Reflector
  Viewing Screen
  peaches
  Flashlight (providing light)
  Apples

>take flashlight
taken

>go e
Cultural Plaza
The center of this nice little mall with stores surrounding you.  It is outdoors and deserted unlike how lively it usually is, with the old chinese folk sitting on the benches outside by the bushes playing there violin, and the many old chinese folk slowly moving there bodies in an intense session of Tai-Chi.

>go nw
Hair Salon
A hair salon with little pieces of hair on the floor everywhere.  You see a beautiful safe.

You can see a pair of scissors and a wad of hair (closed) here.

>take scissors
Taken.

>cut hair
Cutting that up would achieve little.

>open hair
It seems to be locked.

>x hair
A wad of hair leftover from someone's haircut.

>go se
Cultural Plaza
The center of this nice little mall with stores surrounding you.  It is outdoors and deserted unlike how lively it usually is, with the old chinese folk sitting on the benches outside by the bushes playing there violin, and the many old chinese folk slowly moving there bodies in an intense session of Tai-Chi.

>go ne
Furniture Store
Lots of furniture clutter the store.

You can see a couch and shutter here.

>search couch
You search the gaps in the couch cushions. 
You find a crumpled paper.

>i
You are carrying:
  crumpled paper
  a pair of scissors
  Flashlight (providing light)
  an Instruction Manual
  Reflector
  Viewing Screen
  peaches
  Apples

Madman Mercer walks to another room.

>go sw
Cultural Plaza
The center of this nice little mall with stores surrounding you.  It is outdoors and deserted unlike how lively it usually is, with the old chinese folk sitting on the benches outside by the bushes playing there violin, and the many old chinese folk slowly moving there bodies in an intense session of Tai-Chi.

You can see Madman Mercer here.

Madman Mercer walks to another room.

>go sw
Convenience Store
A small family run convenience store filled with racks of snack, and a fridge of drinks.

You can see Madman Mercer, racks of snacks, Condenser Lens, and a Store Clerk here.

Madman Mercer walks to another room.

>take condenser lens
Taken.

>go ne
Cultural Plaza
The center of this nice little mall with stores surrounding you.  It is outdoors and deserted unlike how lively it usually is, with the old chinese folk sitting on the benches outside by the bushes playing there violin, and the many old chinese folk slowly moving there bodies in an intense session of Tai-Chi.

>go se
Bathroom
A stinky smelling bathroom.  Urinals lining the wall and unflushed toilets fill the bathroom.

You can see Imaging Lens, beautiful key, and a toilet (in which is poop) here.

you have the urge to POOP

>take imaging lens
Taken.

>go nw
Cultural Plaza
The center of this nice little mall with stores surrounding you.  It is outdoors and deserted unlike how lively it usually is, with the old chinese folk sitting on the benches outside by the bushes playing there violin, and the many old chinese folk slowly moving there bodies in an intense session of Tai-Chi.

>i
You are carrying:
  Imaging Lens
  Condenser Lens
  crumpled paper
  a pair of scissors
  Flashlight (providing light)
  an Instruction Manual
  Reflector
  Viewing Screen
  peaches
  Apples

>x manual
How to Build a Film Projector for Dummies:

Steps:

*note: must combine in this order

1. Combine flashlight with Reflector

2. Combine flashlight Reflector Thing with Condenser Lens

3. Combine flashlight Reflector Condenser Lens Thing with Imaging Lens

4. Combine flashlight Reflector Condenser Lens Imaging Lens Thing with Shutter

5. Combine flashlight Reflector Condenser Lens Imaging Lens Shutter Thing with Viewing Screen

6. After combining you should have a Film Projector

7. Find Film

>combine flashlight with reflector
You fuse together Flashlight and Reflector.

You now have a flashlight Reflector Thing.

>combine flashlight reflector thing with condenser lens
You fuse together flashlight Reflector Thing and Condenser Lens.

You now have a flashlight Reflector Condenser Lens Thing.

>combine flashlight reflector condenser lens thing with imaging lens
You fuse together flashlight Reflector Condenser Lens Thing and Imaging Lens.

You now have a flashlight Reflector Condenser Lens Imaging Lens Thing.

>combine flashlight reflector condenser lens imaging lens thing with shutter
You can't see any such thing.

>flashlight Reflector Condenser Lens Imaging Lens Thing with shutter
That's not a verb I recognise.

>combine flashlight Reflector Condenser Lens Imaging Lens Thing with shutter
You can't see any such thing.

>combine flashlight Reflector Condenser Lens Imaging Lens Thing with shutter
You can't see any such thing.

>i
You are carrying:
  flashlight Reflector Condenser Lens Imaging Lens Thing (providing light)
  crumpled paper
  a pair of scissors
  an Instruction Manual
  Viewing Screen
  peaches
  Apples

>go sw
Convenience Store
A small family run convenience store filled with racks of snack, and a fridge of drinks.

You can see racks of snacks and a Store Clerk here.

>take shutter
You can't see any such thing.

>undo
Convenience Store
[Previous turn undone.]

>undo
Cultural Plaza
[Previous turn undone.]

>undo
Cultural Plaza
[Previous turn undone.]

>undo
"Undo" failed.  [Not all interpreters provide it.]

>undo
"Undo" failed.  [Not all interpreters provide it.]

>l
Cultural Plaza
The center of this nice little mall with stores surrounding you.  It is outdoors and deserted unlike how lively it usually is, with the old chinese folk sitting on the benches outside by the bushes playing there violin, and the many old chinese folk slowly moving there bodies in an intense session of Tai-Chi.

You can see Madman Mercer here.

Madman Mercer walks to another room.

>i
You are carrying:
  flashlight Reflector Condenser Lens Imaging Lens Thing (providing light)
  crumpled paper
  a pair of scissors
  an Instruction Manual
  Viewing Screen
  peaches
  Apples

>undo
Cultural Plaza
[Previous turn undone.]

* * *

>undo
"Undo" failed.  [Not all interpreters provide it.]

>i
You are carrying:
  flashlight Reflector Condenser Lens Imaging Lens Thing (providing light)
  crumpled paper
  a pair of scissors
  an Instruction Manual
  Viewing Screen
  peaches
  Apples

Madman Mercer walks to another room.

>undo
Cultural Plaza
[Previous turn undone.]

* * *

>undo
"Undo" failed.  [Not all interpreters provide it.]

>go se
Bathroom
A stinky smelling bathroom.  Urinals lining the wall and unflushed toilets fill the bathroom.

You can see beautiful key and a toilet (in which is poop) here.

>go nw
Cultural Plaza
The center of this nice little mall with stores surrounding you.  It is outdoors and deserted unlike how lively it usually is, with the old chinese folk sitting on the benches outside by the bushes playing there violin, and the many old chinese folk slowly moving there bodies in an intense session of Tai-Chi.

>go sw
Convenience Store
A small family run convenience store filled with racks of snack, and a fridge of drinks.

You can see racks of snacks and a Store Clerk here.

>ne
Cultural Plaza
The center of this nice little mall with stores surrounding you.  It is outdoors and deserted unlike how lively it usually is, with the old chinese folk sitting on the benches outside by the bushes playing there violin, and the many old chinese folk slowly moving there bodies in an intense session of Tai-Chi.

>go ne
Furniture Store
Lots of furniture clutter the store.

You can see a couch, shutter, and a green key here.

>take shutter
Taken.

>i
You are carrying:
  shutter
  flashlight Reflector Condenser Lens Imaging Lens Thing (providing light)
  crumpled paper
  a pair of scissors
  an Instruction Manual
  Viewing Screen
  peaches
  Apples

>combine flashlight Reflector Condenser Lens Imaging Lens Thing with shutter
You fuse together flashlight Reflector Condenser Lens Imaging Lens Thing and shutter.

You now have a flashlight Reflector Condenser Lens Imaging Lens Shutter Thing.

>combine flashlight Reflector Condenser Lens Imaging Lens shutter Thing with viewing screen
You fuse together flashlight Reflector Condenser Lens Imaging Lens Shutter Thing and Viewing Screen.

You now have a Film Projector.

>go sw
Cultural Plaza
The center of this nice little mall with stores surrounding you.  It is outdoors and deserted unlike how lively it usually is, with the old chinese folk sitting on the benches outside by the bushes playing there violin, and the many old chinese folk slowly moving there bodies in an intense session of Tai-Chi.

>go n
Stage
A large stage used for lion dance shows, Kung Fu performance, and many other performances or events.  There is a nice big curtain at the back of the stage to conceal the backstage of performers and props.

You can see a red door and fancy key here.

>go s
Cultural Plaza
The center of this nice little mall with stores surrounding you.  It is outdoors and deserted unlike how lively it usually is, with the old chinese folk sitting on the benches outside by the bushes playing there violin, and the many old chinese folk slowly moving there bodies in an intense session of Tai-Chi.

>nw
Hair Salon
A hair salon with little pieces of hair on the floor everywhere.  You see a beautiful safe.

You can see Madman Mercer and a wad of hair (closed) here.

Madman Mercer walks to another room.

>go se
Cultural Plaza
The center of this nice little mall with stores surrounding you.  It is outdoors and deserted unlike how lively it usually is, with the old chinese folk sitting on the benches outside by the bushes playing there violin, and the many old chinese folk slowly moving there bodies in an intense session of Tai-Chi.

>go ne
Furniture Store
Lots of furniture clutter the store.

You can see a couch and a green key here.

>search couch
You search the gaps in the couch cushions. 
You find a crumpled paper.

Madman Mercer walks to another room.

>go sw
Cultural Plaza
The center of this nice little mall with stores surrounding you.  It is outdoors and deserted unlike how lively it usually is, with the old chinese folk sitting on the benches outside by the bushes playing there violin, and the many old chinese folk slowly moving there bodies in an intense session of Tai-Chi.

>go e
video store
A rental video shop, with stands and stands of videos.

You can see a red key here.

>take red key
Taken.

>go w
Cultural Plaza
The center of this nice little mall with stores surrounding you.  It is outdoors and deserted unlike how lively it usually is, with the old chinese folk sitting on the benches outside by the bushes playing there violin, and the many old chinese folk slowly moving there bodies in an intense session of Tai-Chi.

>go n
Stage
A large stage used for lion dance shows, Kung Fu performance, and many other performances or events.  There is a nice big curtain at the back of the stage to conceal the backstage of performers and props.

You can see a red door and fancy key here.

>unlock red door
What do you want to unlock the red door with?

>red key
You unlock the red door.

>open red door
You open the red door.

>go n
Backstage
A strange room that you wouldn't have guessed to be behind the stage of Cultual Plaza.  The room surrounds you with metal walls and a very bright light, like the ones they use in surgeries hanging from the ceiling.

A metal box the size of and Xbox 360, that has a dial which can spin to any number on the front.  It looks very solid, so I wouldn't waste your energy on trying force it open.

You can also see a red door here.

>spin dial to 1384
Clonk! and the metal door swings slowly open, revealing Film Footage.

Madman Mercer walks to another room.

>take film
(Film Footage)
Taken.

>play film
Which do you mean, Film Footage or Film Projector?

>Film
Which do you mean, Film Footage or Film Projector?

>film footage
you put the film into the projector and you start the projector up.  It starts playing a movie of the movie theater that your friends are at.  You start feeling drowsy and you fall unconcious.  You wake up at the movie theater next to your friends.  You ask them about your absence.  They tell you that you were sleeping the whole time.  Maybe it was all a dream?

    *** You have won ***

Would you like to RESTART, RESTORE a saved game, QUIT, or UNDO the last command?

>undo
Backstage
[Previous turn undone.]

>x me
You are boy named Dominuse, who is asian.  You are wearing shorts and a t-shirt.  You are a pretty tick guy.

>take all
Think again big boy.

* * *

>n
Stage
A large stage used for lion dance shows, Kung Fu performance, and many other performances or events.  There is a red door leading to the backstage.  The exit to Cultural Plaza is to the south.

You can see a red door and fancy key here.

You are safe from Madman Mercer for now.

>go s
Cultural Plaza
The center of this nice little mall with stores surrounding you, and bushes decorating the outside.  It is outdoors and deserted.  No one is sitting on the benches like they usually do.
  
There is a nice little directory here too, showing all the stores.

You can see Madman Mercer, a worn out book, and an Instruction Manual here.

You hear the speedy swings of the machete cutting the air.

>s
Fish Market
Fishy smelling market where you can hear the clueless chinese fisherman who is unaware of Madman Mercer, yelling in his accent "Come get yo ninety nine sense fish.  Veeery cheap fish.".  The exit to Cultural Plaza is to the north.

You can see Reflector and a chinese fisherman here.

You are safe from Madman Mercer for now.

>i
You are carrying nothing.

You are safe from Madman Mercer for now.

>n
Cultural Plaza
The center of this nice little mall with stores surrounding you, and bushes decorating the outside.  It is outdoors and deserted.  No one is sitting on the benches like they usually do.
  
There is a nice little directory here too, showing all the stores.

You can see a worn out book and an Instruction Manual here.

You are safe from Madman Mercer for now.

>n
Stage
A large stage used for lion dance shows, Kung Fu performance, and many other performances or events.  There is a red door leading to the backstage.  The exit to Cultural Plaza is to the south.

You can see a red door and fancy key here.

You hear the speedy swings of the machete cutting the air.
You can hear the loud heavy footsteps from the Madman Mercer as he walks into the room,  I would recommend not staying too long in this room.

Madman Mercer looks into your soul with his blood shot eyes running at you.  I wouldn't be in his line of sight for too long if i were you.

>s
Cultural Plaza
The center of this nice little mall with stores surrounding you, and bushes decorating the outside.  It is outdoors and deserted.  No one is sitting on the benches like they usually do.
  
There is a nice little directory here too, showing all the stores.

You can see a worn out book and an Instruction Manual here.

Madman Mercer looks into your soul with his blood shot eyes running at you.  I wouldn't be in his line of sight for too long if i were you.

>take book
Taken.

Madman Mercer looks into your soul with his blood shot eyes running at you.  I wouldn't be in his line of sight for too long if i were you.

>take manual
Taken.

Madman Mercer looks into your soul with his blood shot eyes running at you.  I wouldn't be in his line of sight for too long if i were you.

>ne
Furniture Store
Lots of furniture clutter the store.  The exit to Cultural Plaza is to the southwest.

You can see a couch and shutter here.

Madman Mercer looks into your soul with his blood shot eyes running at you.  I wouldn't be in his line of sight for too long if i were you.

>i
You are carrying:
  an Instruction Manual
  a worn out book
  Madman Mercer

Madman Mercer looks into your soul with his blood shot eyes running at you.  I wouldn't be in his line of sight for too long if i were you.

    *** You have died ***

Would you like to RESTART, RESTORE a saved game, QUIT, or UNDO the last command?

>sw
Please give one of the answers above.

Would you like to RESTART, RESTORE a saved game, QUIT, or UNDO the last command?

>s
Please give one of the answers above.

Would you like to RESTART, RESTORE a saved game, QUIT, or UNDO the last command?

>take reflector
Please give one of the answers above.

Would you like to RESTART, RESTORE a saved game, QUIT, or UNDO the last command?

>n
Please give one of the answers above.

Would you like to RESTART, RESTORE a saved game, QUIT, or UNDO the last command?

>nw
Please give one of the answers above.

Would you like to RESTART, RESTORE a saved game, QUIT, or UNDO the last command?

>take scissors
Please give one of the answers above.

Would you like to RESTART, RESTORE a saved game, QUIT, or UNDO the last command?

>se
Please give one of the answers above.

Would you like to RESTART, RESTORE a saved game, QUIT, or UNDO the last command?

>sw
Please give one of the answers above.

Would you like to RESTART, RESTORE a saved game, QUIT, or UNDO the last command?

>se
Please give one of the answers above.

Would you like to RESTART, RESTORE a saved game, QUIT, or UNDO the last command?

>ne
Please give one of the answers above.

Would you like to RESTART, RESTORE a saved game, QUIT, or UNDO the last command?

>sw
Please give one of the answers above.

Would you like to RESTART, RESTORE a saved game, QUIT, or UNDO the last command?

>ne
Please give one of the answers above.

Would you like to RESTART, RESTORE a saved game, QUIT, or UNDO the last command?

>se
Please give one of the answers above.

Would you like to RESTART, RESTORE a saved game, QUIT, or UNDO the last command?

>take lens
Please give one of the answers above.

Would you like to RESTART, RESTORE a saved game, QUIT, or UNDO the last command?

>take key
Please give one of the answers above.

Would you like to RESTART, RESTORE a saved game, QUIT, or UNDO the last command?

>x toilet
Please give one of the answers above.

Would you like to RESTART, RESTORE a saved game, QUIT, or UNDO the last command?

>flush toilet
Please give one of the answers above.

Would you like to RESTART, RESTORE a saved game, QUIT, or UNDO the last command?

>i
Please give one of the answers above.

Would you like to RESTART, RESTORE a saved game, QUIT, or UNDO the last command?

>take soggy paper
Please give one of the answers above.

Would you like to RESTART, RESTORE a saved game, QUIT, or UNDO the last command?

>nw
Please give one of the answers above.

Would you like to RESTART, RESTORE a saved game, QUIT, or UNDO the last command?

>w
Please give one of the answers above.

Would you like to RESTART, RESTORE a saved game, QUIT, or UNDO the last command?

>e
Please give one of the answers above.

Would you like to RESTART, RESTORE a saved game, QUIT, or UNDO the last command?

>e
Please give one of the answers above.

Would you like to RESTART, RESTORE a saved game, QUIT, or UNDO the last command?

>take key
Please give one of the answers above.

Would you like to RESTART, RESTORE a saved game, QUIT, or UNDO the last command?

>take screen
Please give one of the answers above.

Would you like to RESTART, RESTORE a saved game, QUIT, or UNDO the last command?

>w
Please give one of the answers above.

Would you like to RESTART, RESTORE a saved game, QUIT, or UNDO the last command?

>w
Please give one of the answers above.

Would you like to RESTART, RESTORE a saved game, QUIT, or UNDO the last command?

>take apples
Please give one of the answers above.

Would you like to RESTART, RESTORE a saved game, QUIT, or UNDO the last command?

>take flashlight
Please give one of the answers above.

Would you like to RESTART, RESTORE a saved game, QUIT, or UNDO the last command?

>e
Please give one of the answers above.

Would you like to RESTART, RESTORE a saved game, QUIT, or UNDO the last command?

>sw
Please give one of the answers above.

Would you like to RESTART, RESTORE a saved game, QUIT, or UNDO the last command?

>take lens
Please give one of the answers above.

Would you like to RESTART, RESTORE a saved game, QUIT, or UNDO the last command?

>x snacks
Please give one of the answers above.

Would you like to RESTART, RESTORE a saved game, QUIT, or UNDO the last command?

>talk to clerk
Please give one of the answers above.

Would you like to RESTART, RESTORE a saved game, QUIT, or UNDO the last command?

>give apples
Please give one of the answers above.

Would you like to RESTART, RESTORE a saved game, QUIT, or UNDO the last command?

>ne
Please give one of the answers above.

Would you like to RESTART, RESTORE a saved game, QUIT, or UNDO the last command?

>i
Please give one of the answers above.

Would you like to RESTART, RESTORE a saved game, QUIT, or UNDO the last command?

>x manual
Please give one of the answers above.

Would you like to RESTART, RESTORE a saved game, QUIT, or UNDO the last command?

>ne
Please give one of the answers above.

Would you like to RESTART, RESTORE a saved game, QUIT, or UNDO the last command?

>take shutter
Please give one of the answers above.

Would you like to RESTART, RESTORE a saved game, QUIT, or UNDO the last command?

>x couch
Please give one of the answers above.

Would you like to RESTART, RESTORE a saved game, QUIT, or UNDO the last command?

>search couch
Please give one of the answers above.

Would you like to RESTART, RESTORE a saved game, QUIT, or UNDO the last command?

>take paper
Please give one of the answers above.

Would you like to RESTART, RESTORE a saved game, QUIT, or UNDO the last command?

>wrinkled paper
Please give one of the answers above.

Would you like to RESTART, RESTORE a saved game, QUIT, or UNDO the last command?

>i
Please give one of the answers above.

Would you like to RESTART, RESTORE a saved game, QUIT, or UNDO the last command?

>sw
Please give one of the answers above.

Would you like to RESTART, RESTORE a saved game, QUIT, or UNDO the last command?

>n
Please give one of the answers above.

Would you like to RESTART, RESTORE a saved game, QUIT, or UNDO the last command?

>take key
Please give one of the answers above.

Would you like to RESTART, RESTORE a saved game, QUIT, or UNDO the last command?

>unlock red door
Please give one of the answers above.

Would you like to RESTART, RESTORE a saved game, QUIT, or UNDO the last command?

>red key
Please give one of the answers above.

Would you like to RESTART, RESTORE a saved game, QUIT, or UNDO the last command?

>n
Please give one of the answers above.

Would you like to RESTART, RESTORE a saved game, QUIT, or UNDO the last command?

* * *

>s
Please give one of the answers above.

Would you like to RESTART, RESTORE a saved game, QUIT, or UNDO the last command?

>sw
Please give one of the answers above.

Would you like to RESTART, RESTORE a saved game, QUIT, or UNDO the last command?

* * *

>se
Please give one of the answers above.

Would you like to RESTART, RESTORE a saved game, QUIT, or UNDO the last command?

>flush toilet
Please give one of the answers above.

Would you like to RESTART, RESTORE a saved game, QUIT, or UNDO the last command?

>x toilet
Please give one of the answers above.

Would you like to RESTART, RESTORE a saved game, QUIT, or UNDO the last command?

>nw
Please give one of the answers above.

Would you like to RESTART, RESTORE a saved game, QUIT, or UNDO the last command?

>n
Please give one of the answers above.

Would you like to RESTART, RESTORE a saved game, QUIT, or UNDO the last command?

* * *

>s
Please give one of the answers above.

Would you like to RESTART, RESTORE a saved game, QUIT, or UNDO the last command?

>undo
Furniture Store
[Previous turn undone.]

>s
You can't go that way.

Madman Mercer looks into your soul with his blood shot eyes running at you.  I wouldn't be in his line of sight for too long if i were you.

    *** You have died ***

Would you like to RESTART, RESTORE a saved game, QUIT, or UNDO the last command?

>undo
Furniture Store
[Previous turn undone.]

>undo
Cultural Plaza
[Previous turn undone.]

>undo
Stage
[Previous turn undone.]

>undo
"Undo" failed.  [Not all interpreters provide it.]

>nw
You can't go that way.

Madman Mercer looks into your soul with his blood shot eyes running at you.  I wouldn't be in his line of sight for too long if i were you.

>n
(first opening the red door)
It seems to be locked.

Madman Mercer looks into your soul with his blood shot eyes running at you.  I wouldn't be in his line of sight for too long if i were you.

>n
(first opening the red door)
It seems to be locked.

Madman Mercer looks into your soul with his blood shot eyes running at you.  I wouldn't be in his line of sight for too long if i were you.

>spin dial to 1384
You can't see any such thing.

>take film footage
You can't see any such thing.

>x manual
You can't see any such thing.

>combine flashlight with reflector
You can't see any such thing.

>Combine flashlight Reflector Thing with Condenser Lens
You can't see any such thing.

>s
Cultural Plaza
The center of this nice little mall with stores surrounding you, and bushes decorating the outside.  It is outdoors and deserted.  No one is sitting on the benches like they usually do.
  
There is a nice little directory here too, showing all the stores.

You can see a worn out book and an Instruction Manual here.

Madman Mercer looks into your soul with his blood shot eyes running at you.  I wouldn't be in his line of sight for too long if i were you.

>Combine flashlight Reflector Condenser Lens Thing with Imaging Lens
You can't see any such thing.

>Combine flashlight Reflector Condenser Lens Imaging Lens Thing with Shutter
You can't see any such thing.

>Combine flashlight Reflector Condenser Lens Imaging Lens Shutter Thing with Viewing Screen
You can't see any such thing.

>x projector
You can't see any such thing.

>play film
You can't see any such thing.

>footage
That's not a verb I recognise.

>restart
Are you sure you want to restart?

* * *

>n
Stage
A large stage used for lion dance shows, Kung Fu performance, and many other performances or events.  There is a red door leading to the backstage.  The exit to Cultural Plaza is to the south.

You can see a red door and fancy key here.

You are safe from Madman Mercer for now.

>n
(first opening the red door)
It seems to be locked.

You hear the speedy swings of the machete cutting the air.

You are safe from Madman Mercer for now.

>s
Cultural Plaza
The center of this nice little mall with stores surrounding you, and bushes decorating the outside.  It is outdoors and deserted.  No one is sitting on the benches like they usually do.
  
There is a nice little directory here too, showing all the stores.

You can see a worn out book and an Instruction Manual here.

Madman Mercer looks into your soul with his blood shot eyes running at you.  I wouldn't be in his line of sight for too long if i were you.

>s
Fish Market
Fishy smelling market where you can hear the clueless chinese fisherman who is unaware of Madman Mercer, yelling in his accent "Come get yo ninety nine sense fish.  Veeery cheap fish.".  The exit to Cultural Plaza is to the north.

You can see Reflector and a chinese fisherman here.

Madman Mercer looks into your soul with his blood shot eyes running at you.  I wouldn't be in his line of sight for too long if i were you.

>s
You can't go that way.

Madman Mercer looks into your soul with his blood shot eyes running at you.  I wouldn't be in his line of sight for too long if i were you.

You are safe from Madman Mercer for now.

>n
Cultural Plaza
The center of this nice little mall with stores surrounding you, and bushes decorating the outside.  It is outdoors and deserted.  No one is sitting on the benches like they usually do.
  
There is a nice little directory here too, showing all the stores.

You can see a worn out book and an Instruction Manual here.

Madman Mercer looks into your soul with his blood shot eyes running at you.  I wouldn't be in his line of sight for too long if i were you.

>n
Stage
A large stage used for lion dance shows, Kung Fu performance, and many other performances or events.  There is a red door leading to the backstage.  The exit to Cultural Plaza is to the south.

You can see a red door and fancy key here.

You are safe from Madman Mercer for now.

>n
(first opening the red door)
It seems to be locked.

You are safe from Madman Mercer for now.

>n
(first opening the red door)
It seems to be locked.

You hear the speedy swings of the machete cutting the air.
You can hear the loud heavy footsteps from the Madman Mercer.  I would recommend not staying too long in this room.

You are safe from Madman Mercer for now.

>n
(first opening the red door)
It seems to be locked.

You are safe from Madman Mercer for now.

>n
(first opening the red door)
It seems to be locked.

You are safe from Madman Mercer for now.

>s
Cultural Plaza
The center of this nice little mall with stores surrounding you, and bushes decorating the outside.  It is outdoors and deserted.  No one is sitting on the benches like they usually do.
  
There is a nice little directory here too, showing all the stores.

You can see Madman Mercer, a worn out book, and an Instruction Manual here.

Madman Mercer looks into your soul with his blood shot eyes running at you.  I wouldn't be in his line of sight for too long if i were you.

You are safe from Madman Mercer for now.

>s
Fish Market
Fishy smelling market where you can hear the clueless chinese fisherman who is unaware of Madman Mercer, yelling in his accent "Come get yo ninety nine sense fish.  Veeery cheap fish.".  The exit to Cultural Plaza is to the north.

You can see Reflector and a chinese fisherman here.

You are safe from Madman Mercer for now.

* * *

>s
You can't go that way.

You are safe from Madman Mercer for now.

>s
You can't go that way.

You are safe from Madman Mercer for now.

>s
You can't go that way.

You hear the speedy swings of the machete cutting the air.
You can hear the loud heavy footsteps from the Madman Mercer.  I would recommend not staying too long in this room.

You are safe from Madman Mercer for now.

>n
Cultural Plaza
The center of this nice little mall with stores surrounding you, and bushes decorating the outside.  It is outdoors and deserted.  No one is sitting on the benches like they usually do.
  
There is a nice little directory here too, showing all the stores.

You can see a worn out book and an Instruction Manual here.

Madman Mercer looks into your soul with his blood shot eyes running at you.  I wouldn't be in his line of sight for too long if i were you.

* * *

>n
Stage
A large stage used for lion dance shows, Kung Fu performance, and many other performances or events.  There is a red door leading to the backstage.  The exit to Cultural Plaza is to the south.

You can see a red door and fancy key here.

You are safe from Madman Mercer for now.

>s
Cultural Plaza
The center of this nice little mall with stores surrounding you, and bushes decorating the outside.  It is outdoors and deserted.  No one is sitting on the benches like they usually do.
  
There is a nice little directory here too, showing all the stores.

You can see a worn out book and an Instruction Manual here.

Madman Mercer looks into your soul with his blood shot eyes running at you.  I wouldn't be in his line of sight for too long if i were you.

>s
Fish Market
Fishy smelling market where you can hear the clueless chinese fisherman who is unaware of Madman Mercer, yelling in his accent "Come get yo ninety nine sense fish.  Veeery cheap fish.".  The exit to Cultural Plaza is to the north.

You can see Reflector and a chinese fisherman here.

You hear the speedy swings of the machete cutting the air.
You can hear the loud heavy footsteps from the Madman Mercer.  I would recommend not staying too long in this room.

You are safe from Madman Mercer for now.

>s
You can't go that way.

You are safe from Madman Mercer for now.

>n
Cultural Plaza
The center of this nice little mall with stores surrounding you, and bushes decorating the outside.  It is outdoors and deserted.  No one is sitting on the benches like they usually do.
  
There is a nice little directory here too, showing all the stores.

You can see Madman Mercer, a worn out book, and an Instruction Manual here.

Madman Mercer looks into your soul with his blood shot eyes running at you.  I wouldn't be in his line of sight for too long if i were you.

You are safe from Madman Mercer for now.

>n
Stage
A large stage used for lion dance shows, Kung Fu performance, and many other performances or events.  There is a red door leading to the backstage.  The exit to Cultural Plaza is to the south.

You can see a red door and fancy key here.

You are safe from Madman Mercer for now.

>s
Cultural Plaza
The center of this nice little mall with stores surrounding you, and bushes decorating the outside.  It is outdoors and deserted.  No one is sitting on the benches like they usually do.
  
There is a nice little directory here too, showing all the stores.

You can see Madman Mercer, a worn out book, and an Instruction Manual here.

Madman Mercer looks into your soul with his blood shot eyes running at you.  I wouldn't be in his line of sight for too long if i were you.

You are safe from Madman Mercer for now.

* * *

>s
Fish Market
Fishy smelling market where you can hear the clueless chinese fisherman who is unaware of Madman Mercer, yelling in his accent "Come get yo ninety nine sense fish.  Veeery cheap fish.".  The exit to Cultural Plaza is to the north.

You can see Reflector and a chinese fisherman here.

You are safe from Madman Mercer for now.

>n
Cultural Plaza
The center of this nice little mall with stores surrounding you, and bushes decorating the outside.  It is outdoors and deserted.  No one is sitting on the benches like they usually do.
  
There is a nice little directory here too, showing all the stores.

You can see Madman Mercer, a worn out book, and an Instruction Manual here.

Madman Mercer looks into your soul with his blood shot eyes running at you.  I wouldn't be in his line of sight for too long if i were you.

You are safe from Madman Mercer for now.

* * *

>s
Fish Market
Fishy smelling market where you can hear the clueless chinese fisherman who is unaware of Madman Mercer, yelling in his accent "Come get yo ninety nine sense fish.  Veeery cheap fish.".  The exit to Cultural Plaza is to the north.

You can see Reflector and a chinese fisherman here.

You are safe from Madman Mercer for now.

>e
You can't go that way.

You are safe from Madman Mercer for now.

>n
Cultural Plaza
The center of this nice little mall with stores surrounding you, and bushes decorating the outside.  It is outdoors and deserted.  No one is sitting on the benches like they usually do.
  
There is a nice little directory here too, showing all the stores.

You can see a worn out book and an Instruction Manual here.

Madman Mercer looks into your soul with his blood shot eyes running at you.  I wouldn't be in his line of sight for too long if i were you.

>undo
Fish Market
[Previous turn undone.]

>undo
Fish Market
[Previous turn undone.]

>undo
Cultural Plaza
[Previous turn undone.]

>w
Fruit store
Many different baskets of fruit fill the store.  The exit to Cultural Plaza is to the east.

You can see Madman Mercer, green basket (in which is pears), pink basket (in which is peaches), and a red basket (in which is Apples) here.

The red basket catches your attention.

Madman Mercer looks into your soul with his blood shot eyes running at you.  I wouldn't be in his line of sight for too long if i were you.

You are safe from Madman Mercer for now.

>e
Cultural Plaza
The center of this nice little mall with stores surrounding you, and bushes decorating the outside.  It is outdoors and deserted.  No one is sitting on the benches like they usually do.
  
There is a nice little directory here too, showing all the stores.

You can see Madman Mercer, a worn out book, and an Instruction Manual here.

Madman Mercer looks into your soul with his blood shot eyes running at you.  I wouldn't be in his line of sight for too long if i were you.

You are safe from Madman Mercer for now.

>ne
Furniture Store
Lots of furniture clutter the store.  The exit to Cultural Plaza is to the southwest.

You can see a couch and shutter here.

You are safe from Madman Mercer for now.

>n
You can't go that way.

You hear the speedy swings of the machete cutting the air.

You are safe from Madman Mercer for now.

>n
You can't go that way.

You are safe from Madman Mercer for now.

>s
You can't go that way.

You are safe from Madman Mercer for now.

I beg your pardon?

>n
You can't go that way.

You hear the speedy swings of the machete cutting the air.

You are safe from Madman Mercer for now.

>n
You can't go that way.

You hear the speedy swings of the machete cutting the air.
You can hear the loud heavy footsteps from the Madman Mercer.  I would recommend not staying too long in this room.

You are safe from Madman Mercer for now.

I beg your pardon?

I beg your pardon?

>n
You can't go that way.

You are safe from Madman Mercer for now.

>nnn
That's not a verb I recognise.

>n
You can't go that way.

You are safe from Madman Mercer for now.

* * *

>s
You can't go that way.

You are safe from Madman Mercer for now.

>sw
try find a flashlight first.

You are safe from Madman Mercer for now.

>sw
Cultural Plaza
The center of this nice little mall with stores surrounding you, and bushes decorating the outside.  It is outdoors and deserted.  No one is sitting on the benches like they usually do.
  
There is a nice little directory here too, showing all the stores.

You can see a worn out book and an Instruction Manual here.

Madman Mercer looks into your soul with his blood shot eyes running at you.  I wouldn't be in his line of sight for too long if i were you.

>n
Stage
A large stage used for lion dance shows, Kung Fu performance, and many other performances or events.  There is a red door leading to the backstage.  The exit to Cultural Plaza is to the south.

You can see a red door and fancy key here.

You are safe from Madman Mercer for now.

* * *

>s
You can't go that way.

You hear the speedy swings of the machete cutting the air.
You can hear the loud heavy footsteps from the Madman Mercer.  I would recommend not staying too long in this room.

You are safe from Madman Mercer for now.

>s
You can't go that way.

You are safe from Madman Mercer for now.

* * *

>n
(first opening the red door)
It seems to be locked.

You are safe from Madman Mercer for now.

>s
Cultural Plaza
The center of this nice little mall with stores surrounding you, and bushes decorating the outside.  It is outdoors and deserted.  No one is sitting on the benches like they usually do.
  
There is a nice little directory here too, showing all the stores.

You can see a worn out book and an Instruction Manual here.

Madman Mercer looks into your soul with his blood shot eyes running at you.  I wouldn't be in his line of sight for too long if i were you.

>s
Fish Market
Fishy smelling market where you can hear the clueless chinese fisherman who is unaware of Madman Mercer, yelling in his accent "Come get yo ninety nine sense fish.  Veeery cheap fish.".  The exit to Cultural Plaza is to the north.

You can see Reflector and a chinese fisherman here.

You are safe from Madman Mercer for now.

* * *

>s
You can't go that way.

You are safe from Madman Mercer for now.

>n
Cultural Plaza
The center of this nice little mall with stores surrounding you, and bushes decorating the outside.  It is outdoors and deserted.  No one is sitting on the benches like they usually do.
  
There is a nice little directory here too, showing all the stores.

You can see Madman Mercer, a worn out book, and an Instruction Manual here.

You hear the speedy swings of the machete cutting the air.

Madman Mercer looks into your soul with his blood shot eyes running at you.  I wouldn't be in his line of sight for too long if i were you.

You are safe from Madman Mercer for now.

>n
Stage
A large stage used for lion dance shows, Kung Fu performance, and many other performances or events.  There is a red door leading to the backstage.  The exit to Cultural Plaza is to the south.

You can see a red door and fancy key here.

You are safe from Madman Mercer for now.

>n
(first opening the red door)
It seems to be locked.

Madman Mercer looks into your soul with his blood shot eyes running at you.  I wouldn't be in his line of sight for too long if i were you.

>n
(first opening the red door)
It seems to be locked.

Madman Mercer looks into your soul with his blood shot eyes running at you.  I wouldn't be in his line of sight for too long if i were you.

You are safe from Madman Mercer for now.

>s
Cultural Plaza
The center of this nice little mall with stores surrounding you, and bushes decorating the outside.  It is outdoors and deserted.  No one is sitting on the benches like they usually do.
  
There is a nice little directory here too, showing all the stores.

You can see Madman Mercer, a worn out book, and an Instruction Manual here.

Madman Mercer looks into your soul with his blood shot eyes running at you.  I wouldn't be in his line of sight for too long if i were you.

You are safe from Madman Mercer for now.

>n
Stage
A large stage used for lion dance shows, Kung Fu performance, and many other performances or events.  There is a red door leading to the backstage.  The exit to Cultural Plaza is to the south.

You can see a red door and fancy key here.

You are safe from Madman Mercer for now.

* * *

>n
Cultural Plaza
The center of this nice little mall with stores surrounding you, and bushes decorating the outside.  It is outdoors and deserted.  No one is sitting on the benches like they usually do.
  
There is a nice little directory here too, showing all the stores.

You can see a worn out book and an Instruction Manual here.

Madman Mercer looks into your soul with his blood shot eyes running at you.  I wouldn't be in his line of sight for too long if i were you.

>ne
Furniture Store
Lots of furniture clutter the store.  The exit to Cultural Plaza is to the southwest.

You can see a couch and shutter here.

You are safe from Madman Mercer for now.

>sw
try find a flashlight first.

You are safe from Madman Mercer for now.

>n
You can't go that way.

You are safe from Madman Mercer for now.

* * *

I beg your pardon?

>sw
Cultural Plaza
The center of this nice little mall with stores surrounding you, and bushes decorating the outside.  It is outdoors and deserted.  No one is sitting on the benches like they usually do.
  
There is a nice little directory here too, showing all the stores.

You can see a worn out book and an Instruction Manual here.

You are safe from Madman Mercer for now.

>n
Stage
A large stage used for lion dance shows, Kung Fu performance, and many other performances or events.  There is a red door leading to the backstage.  The exit to Cultural Plaza is to the south.

You can see a red door and fancy key here.

You are safe from Madman Mercer for now.

>s
Cultural Plaza
The center of this nice little mall with stores surrounding you, and bushes decorating the outside.  It is outdoors and deserted.  No one is sitting on the benches like they usually do.
  
There is a nice little directory here too, showing all the stores.

You can see a worn out book and an Instruction Manual here.

You hear the speedy swings of the machete cutting the air.
You can hear the loud heavy footsteps from the Madman Mercer as he walks into the room,  I would recommend not staying too long in this room.

Madman Mercer looks into your soul with his blood shot eyes running at you.  I wouldn't be in his line of sight for too long if i were you.

>w
Fruit store
Many different baskets of fruit fill the store.  The exit to Cultural Plaza is to the east.

You can see green basket (in which is pears), pink basket (in which is peaches), and a red basket (in which is Apples) here.

The red basket catches your attention.

Madman Mercer looks into your soul with his blood shot eyes running at you.  I wouldn't be in his line of sight for too long if i were you.

>s
You can't go that way.

Madman Mercer looks into your soul with his blood shot eyes running at you.  I wouldn't be in his line of sight for too long if i were you.

>e
Cultural Plaza
The center of this nice little mall with stores surrounding you, and bushes decorating the outside.  It is outdoors and deserted.  No one is sitting on the benches like they usually do.
  
There is a nice little directory here too, showing all the stores.

You can see a worn out book and an Instruction Manual here.

You hear the speedy swings of the machete cutting the air.
You can hear the loud heavy footsteps from the Madman Mercer as he walks into the room,  I would recommend not staying too long in this room.

Madman Mercer looks into your soul with his blood shot eyes running at you.  I wouldn't be in his line of sight for too long if i were you.

>e
video store
A rental video shop, with stands and stands of videos.  The exit to Cultural Plaza is to the west.

You can see a red key and Viewing Screen here.

Madman Mercer looks into your soul with his blood shot eyes running at you.  I wouldn't be in his line of sight for too long if i were you.

    *** You have died ***

Would you like to RESTART, RESTORE a saved game, QUIT, or UNDO the last command?

>s
Please give one of the answers above.

Would you like to RESTART, RESTORE a saved game, QUIT, or UNDO the last command?

>w
Please give one of the answers above.

Would you like to RESTART, RESTORE a saved game, QUIT, or UNDO the last command?

>s
Please give one of the answers above.

Would you like to RESTART, RESTORE a saved game, QUIT, or UNDO the last command?

* * *

>n
Stage
A large stage used for lion dance shows, Kung Fu performance, and many other performances or events.  There is a red door leading to the backstage.  The exit to Cultural Plaza is to the south.

You can see a red door and fancy key here.

You are safe from Madman Mercer for now.

>take fancy key
Taken.

Madman Mercer looks into your soul with his blood shot eyes running at you.  I wouldn't be in his line of sight for too long if i were you.

>s
Cultural Plaza
The center of this nice little mall with stores surrounding you, and bushes decorating the outside.  It is outdoors and deserted.  No one is sitting on the benches like they usually do.
  
There is a nice little directory here too, showing all the stores.

You can see a worn out book and an Instruction Manual here.

You are safe from Madman Mercer for now.

>s
Fish Market
Fishy smelling market where you can hear the clueless chinese fisherman who is unaware of Madman Mercer, yelling in his accent "Come get yo ninety nine sense fish.  Veeery cheap fish.".  The exit to Cultural Plaza is to the north.

You can see Reflector and a chinese fisherman here.

You hear the speedy swings of the machete cutting the air.
You can hear the loud heavy footsteps from the Madman Mercer.  I would recommend not staying too long in this room.

You are safe from Madman Mercer for now.

>n
Cultural Plaza
The center of this nice little mall with stores surrounding you, and bushes decorating the outside.  It is outdoors and deserted.  No one is sitting on the benches like they usually do.
  
There is a nice little directory here too, showing all the stores.

You can see a worn out book and an Instruction Manual here.

You hear the speedy swings of the machete cutting the air.

Madman Mercer looks into your soul with his blood shot eyes running at you.  I wouldn't be in his line of sight for too long if i were you.

>w
Fruit store
Many different baskets of fruit fill the store.  The exit to Cultural Plaza is to the east.

You can see green basket (in which is pears), pink basket (in which is peaches), and a red basket (in which is Apples) here.

The red basket catches your attention.

You are safe from Madman Mercer for now.

>take apples
you take the apples and revealed a flashlight.

You are safe from Madman Mercer for now.

>take flashlight
taken
You are safe from Madman Mercer for now.

>e
Cultural Plaza
The center of this nice little mall with stores surrounding you, and bushes decorating the outside.  It is outdoors and deserted.  No one is sitting on the benches like they usually do.
  
There is a nice little directory here too, showing all the stores.

You can see a worn out book and an Instruction Manual here.

You are safe from Madman Mercer for now.

>sw
try find a flashlight first.

You hear the speedy swings of the machete cutting the air.
You can hear the loud heavy footsteps from the Madman Mercer.  I would recommend not staying too long in this room.

You are safe from Madman Mercer for now.

>sw
Convenience Store
A small family run convenience store filled with racks of snack, and a fridge of drinks.  The exit to Cultural Plaza is to the northeast.

You can see racks of snacks, Condenser Lens, and a Store Clerk here.

You are safe from Madman Mercer for now.

>talk to clerk
Man I'm tired, and could really use some lihing mui apples right now, but this convenience store doesn't have any fresh apples.

Madman Mercer looks into your soul with his blood shot eyes running at you.  I wouldn't be in his line of sight for too long if i were you.

>give apples to clerk
Thanks man you are a life saver.  Here is something as a reward.
You receive a scrap of paper
Madman Mercer looks into your soul with his blood shot eyes running at you.  I wouldn't be in his line of sight for too long if i were you.

You are safe from Madman Mercer for now.

>i
You are carrying:
  scrap of paper
  Flashlight (providing light)
  fancy key

You are safe from Madman Mercer for now.

>ne
Cultural Plaza
The center of this nice little mall with stores surrounding you, and bushes decorating the outside.  It is outdoors and deserted.  No one is sitting on the benches like they usually do.
  
There is a nice little directory here too, showing all the stores.

You can see a worn out book and an Instruction Manual here.

You are safe from Madman Mercer for now.

>s
Fish Market
Fishy smelling market where you can hear the clueless chinese fisherman who is unaware of Madman Mercer, yelling in his accent "Come get yo ninety nine sense fish.  Veeery cheap fish.".  The exit to Cultural Plaza is to the north.

You can see Reflector and a chinese fisherman here.

You are safe from Madman Mercer for now.

>take reflector
Taken.

You hear the speedy swings of the machete cutting the air.
You can hear the loud heavy footsteps from the Madman Mercer.  I would recommend not staying too long in this room.

You are safe from Madman Mercer for now.

>n
Cultural Plaza
The center of this nice little mall with stores surrounding you, and bushes decorating the outside.  It is outdoors and deserted.  No one is sitting on the benches like they usually do.
  
There is a nice little directory here too, showing all the stores.

You can see a worn out book and an Instruction Manual here.

You hear the speedy swings of the machete cutting the air.

You are safe from Madman Mercer for now.

>ne
Furniture Store
Lots of furniture clutter the store.  The exit to Cultural Plaza is to the southwest.

You can see a couch and shutter here.

You are safe from Madman Mercer for now.

>take shitter
You can't see any such thing.

>take shutter
Taken.

You are safe from Madman Mercer for now.

>search couch
You search the gaps in the couch cushions. 
You find a wrinkled paper.

You are safe from Madman Mercer for now.

>i
You are carrying:
  wrinkled paper
  shutter
  Reflector
  scrap of paper
  Flashlight (providing light)
  fancy key

You hear the speedy swings of the machete cutting the air.

Madman Mercer looks into your soul with his blood shot eyes running at you.  I wouldn't be in his line of sight for too long if i were you.

>sw
Cultural Plaza
The center of this nice little mall with stores surrounding you, and bushes decorating the outside.  It is outdoors and deserted.  No one is sitting on the benches like they usually do.
  
There is a nice little directory here too, showing all the stores.

You can see a worn out book and an Instruction Manual here.

You are safe from Madman Mercer for now.

>e
video store
A rental video shop, with stands and stands of videos.  The exit to Cultural Plaza is to the west.

You can see a red key and Viewing Screen here.

You are safe from Madman Mercer for now.

>take red key
Taken.

Madman Mercer looks into your soul with his blood shot eyes running at you.  I wouldn't be in his line of sight for too long if i were you.

>take screen
Taken.

Madman Mercer looks into your soul with his blood shot eyes running at you.  I wouldn't be in his line of sight for too long if i were you.

You are safe from Madman Mercer for now.

>w
Cultural Plaza
The center of this nice little mall with stores surrounding you, and bushes decorating the outside.  It is outdoors and deserted.  No one is sitting on the benches like they usually do.
  
There is a nice little directory here too, showing all the stores.

You can see a worn out book and an Instruction Manual here.

You are safe from Madman Mercer for now.

>se
Bathroom
A stinky smelling bathroom.  Urinals lining the wall and unflushed toilets fill the bathroom.  The exit to Cultural Plaza is to the northwest.

You can see Imaging Lens and a toilet (in which is poop) here.

you have the urge to POOP
You are safe from Madman Mercer for now.

>take imaging lens
Taken.

You are safe from Madman Mercer for now.

>take stinky key
You can't see any such thing.

>poop in toilet
Plop! brown things come from your butt into the toilet.  I recommend you flush it before it stinks up the place.

You are safe from Madman Mercer for now.

>flush toilet
the toilet clogs and a soggy paper and stinky key appears!

You are safe from Madman Mercer for now.

>take soggy paper
Taken.

You are safe from Madman Mercer for now.

>take stinky key
Taken.

You are safe from Madman Mercer for now.

>nw
Cultural Plaza
The center of this nice little mall with stores surrounding you, and bushes decorating the outside.  It is outdoors and deserted.  No one is sitting on the benches like they usually do.
  
There is a nice little directory here too, showing all the stores.

You can see a worn out book and an Instruction Manual here.

You hear the speedy swings of the machete cutting the air.
You can hear the loud heavy footsteps from the Madman Mercer.  I would recommend not staying too long in this room.

Madman Mercer looks into your soul with his blood shot eyes running at you.  I wouldn't be in his line of sight for too long if i were you.

>i
You are carrying:
  stinky key
  soggy paper
  Imaging Lens
  Viewing Screen
  a red key
  wrinkled paper
  shutter
  Reflector
  scrap of paper
  Flashlight (providing light)
  fancy key

Madman Mercer looks into your soul with his blood shot eyes running at you.  I wouldn't be in his line of sight for too long if i were you.

You are safe from Madman Mercer for now.

>go nw
Hair Salon
A hair salon with little pieces of hair on the floor everywhere.  You see a beautiful safe.  The exit to Cultural Plaza is to the southeast.

You can see Madman Mercer here.

Madman Mercer looks into your soul with his blood shot eyes running at you.  I wouldn't be in his line of sight for too long if i were you.

You are safe from Madman Mercer for now.

>se
Cultural Plaza
The center of this nice little mall with stores surrounding you, and bushes decorating the outside.  It is outdoors and deserted.  No one is sitting on the benches like they usually do.
  
There is a nice little directory here too, showing all the stores.

You can see Madman Mercer, a worn out book, and an Instruction Manual here.

You hear the speedy swings of the machete cutting the air.

Madman Mercer looks into your soul with his blood shot eyes running at you.  I wouldn't be in his line of sight for too long if i were you.

You are safe from Madman Mercer for now.

>e
video store
A rental video shop, with stands and stands of videos.  The exit to Cultural Plaza is to the west.

You are safe from Madman Mercer for now.

>w
Cultural Plaza
The center of this nice little mall with stores surrounding you, and bushes decorating the outside.  It is outdoors and deserted.  No one is sitting on the benches like they usually do.
  
There is a nice little directory here too, showing all the stores.

You can see a worn out book and an Instruction Manual here.

You are safe from Madman Mercer for now.

>se
Bathroom
A stinky smelling bathroom.  Urinals lining the wall and unflushed toilets fill the bathroom.  The exit to Cultural Plaza is to the northwest.

You can see a toilet (in which is poop) here.

You are safe from Madman Mercer for now.

>nw
Cultural Plaza
The center of this nice little mall with stores surrounding you, and bushes decorating the outside.  It is outdoors and deserted.  No one is sitting on the benches like they usually do.
  
There is a nice little directory here too, showing all the stores.

You can see a worn out book and an Instruction Manual here.

You hear the speedy swings of the machete cutting the air.

You are safe from Madman Mercer for now.

>nw
Hair Salon
A hair salon with little pieces of hair on the floor everywhere.  You see a beautiful safe.  The exit to Cultural Plaza is to the southeast.

You hear the speedy swings of the machete cutting the air.

You are safe from Madman Mercer for now.

>unlock beautiful safe
What do you want to unlock the beautiful safe with?

>beautiful key
I only understood you as far as wanting to unlock the beautiful safe with the beautiful safe.

>unlock beautiful safe with stinky key
You unlock the beautiful safe.

You are safe from Madman Mercer for now.

>open beautiful safe
you see a small paper.

You are safe from Madman Mercer for now.

>take small ripped paper
I only understood you as far as wanting to take small paper.

>take small paper
Taken.

You are safe from Madman Mercer for now.

>i
You are carrying:
  small paper
  stinky key
  soggy paper
  Imaging Lens
  Viewing Screen
  a red key
  wrinkled paper
  shutter
  Reflector
  scrap of paper
  Flashlight (providing light)
  fancy key

You are safe from Madman Mercer for now.

>open beautiful safe
you see a small paper.

You hear the speedy swings of the machete cutting the air.

You are safe from Madman Mercer for now.

>take small paper
Taken.

You are safe from Madman Mercer for now.

* * *

>i
You are carrying:
  small paper
  stinky key
  soggy paper
  Imaging Lens
  Viewing Screen
  a red key
  wrinkled paper
  shutter
  Reflector
  scrap of paper
  Flashlight (providing light)
  fancy key

You are safe from Madman Mercer for now.

>l
Hair Salon
A hair salon with little pieces of hair on the floor everywhere.  You see a beautiful safe.  The exit to Cultural Plaza is to the southeast.

You can see dirty paper here.

You are safe from Madman Mercer for now.

>se
Cultural Plaza
The center of this nice little mall with stores surrounding you, and bushes decorating the outside.  It is outdoors and deserted.  No one is sitting on the benches like they usually do.
  
There is a nice little directory here too, showing all the stores.

You can see a worn out book and an Instruction Manual here.

You are safe from Madman Mercer for now.

>sw
Convenience Store
A small family run convenience store filled with racks of snack, and a fridge of drinks.  The exit to Cultural Plaza is to the northeast.

You can see racks of snacks, Condenser Lens, and a Store Clerk here.

You are safe from Madman Mercer for now.

>give apples to clerk
You can't see any such thing.

>take scrap of paper
You already have that.

Madman Mercer looks into your soul with his blood shot eyes running at you.  I wouldn't be in his line of sight for too long if i were you.

>i
You are carrying:
  small paper
  stinky key
  soggy paper
  Imaging Lens
  Viewing Screen
  a red key
  wrinkled paper
  shutter
  Reflector
  scrap of paper
  Flashlight (providing light)
  fancy key

Madman Mercer looks into your soul with his blood shot eyes running at you.  I wouldn't be in his line of sight for too long if i were you.

You are safe from Madman Mercer for now.

>ne
Cultural Plaza
The center of this nice little mall with stores surrounding you, and bushes decorating the outside.  It is outdoors and deserted.  No one is sitting on the benches like they usually do.
  
There is a nice little directory here too, showing all the stores.

You can see a worn out book and an Instruction Manual here.

You are safe from Madman Mercer for now.

>e
video store
A rental video shop, with stands and stands of videos.  The exit to Cultural Plaza is to the west.

You are safe from Madman Mercer for now.

* * *

>w
Cultural Plaza
The center of this nice little mall with stores surrounding you, and bushes decorating the outside.  It is outdoors and deserted.  No one is sitting on the benches like they usually do.
  
There is a nice little directory here too, showing all the stores.

You can see a worn out book and an Instruction Manual here.

You are safe from Madman Mercer for now.

>sw
Convenience Store
A small family run convenience store filled with racks of snack, and a fridge of drinks.  The exit to Cultural Plaza is to the northeast.

You can see racks of snacks, Condenser Lens, and a Store Clerk here.

You hear the speedy swings of the machete cutting the air.

You are safe from Madman Mercer for now.

>ne
Cultural Plaza
The center of this nice little mall with stores surrounding you, and bushes decorating the outside.  It is outdoors and deserted.  No one is sitting on the benches like they usually do.
  
There is a nice little directory here too, showing all the stores.

You can see a worn out book and an Instruction Manual here.

You are safe from Madman Mercer for now.

>s
Fish Market
Fishy smelling market where you can hear the clueless chinese fisherman who is unaware of Madman Mercer, yelling in his accent "Come get yo ninety nine sense fish.  Veeery cheap fish.".  The exit to Cultural Plaza is to the north.

You can see a chinese fisherman here.

You are safe from Madman Mercer for now.

>n
Cultural Plaza
The center of this nice little mall with stores surrounding you, and bushes decorating the outside.  It is outdoors and deserted.  No one is sitting on the benches like they usually do.
  
There is a nice little directory here too, showing all the stores.

You can see a worn out book and an Instruction Manual here.

You are safe from Madman Mercer for now.

>ne
Furniture Store
Lots of furniture clutter the store.  The exit to Cultural Plaza is to the southwest.

You can see a couch here.

You are safe from Madman Mercer for now.

>sw
Cultural Plaza
The center of this nice little mall with stores surrounding you, and bushes decorating the outside.  It is outdoors and deserted.  No one is sitting on the benches like they usually do.
  
There is a nice little directory here too, showing all the stores.

You can see a worn out book and an Instruction Manual here.

You are safe from Madman Mercer for now.

>e
video store
A rental video shop, with stands and stands of videos.  The exit to Cultural Plaza is to the west.

You are safe from Madman Mercer for now.

>w
Cultural Plaza
The center of this nice little mall with stores surrounding you, and bushes decorating the outside.  It is outdoors and deserted.  No one is sitting on the benches like they usually do.
  
There is a nice little directory here too, showing all the stores.

You can see Madman Mercer, a worn out book, and an Instruction Manual here.

Madman Mercer looks into your soul with his blood shot eyes running at you.  I wouldn't be in his line of sight for too long if i were you.

You are safe from Madman Mercer for now.

>se
Bathroom
A stinky smelling bathroom.  Urinals lining the wall and unflushed toilets fill the bathroom.  The exit to Cultural Plaza is to the northwest.

You can see a toilet (in which is poop) here.

You are safe from Madman Mercer for now.

>nw
Cultural Plaza
The center of this nice little mall with stores surrounding you, and bushes decorating the outside.  It is outdoors and deserted.  No one is sitting on the benches like they usually do.
  
There is a nice little directory here too, showing all the stores.

You can see a worn out book and an Instruction Manual here.

You are safe from Madman Mercer for now.

>nw
Hair Salon
A hair salon with little pieces of hair on the floor everywhere.  You see a beautiful safe.  The exit to Cultural Plaza is to the southeast.

You can see dirty paper here.

You are safe from Madman Mercer for now.

>take dirty paper
Taken.

You are safe from Madman Mercer for now.

>i
You are carrying:
  dirty paper
  small paper
  stinky key
  soggy paper
  Imaging Lens
  Viewing Screen
  a red key
  wrinkled paper
  shutter
  Reflector
  scrap of paper
  Flashlight (providing light)
  fancy key

You are safe from Madman Mercer for now.

>se
Cultural Plaza
The center of this nice little mall with stores surrounding you, and bushes decorating the outside.  It is outdoors and deserted.  No one is sitting on the benches like they usually do.
  
There is a nice little directory here too, showing all the stores.

You can see a worn out book and an Instruction Manual here.

You are safe from Madman Mercer for now.

>take manual
Taken.

You are safe from Madman Mercer for now.

>x manual
How to Build a Film Projector for Dummies:

Steps:

*note: must combine in this order

1. Combine flashlight with Reflector

2. Combine flashlight Reflector Thing with Condenser Lens

3. Combine flashlight Reflector Condenser Lens Thing with Imaging Lens

4. Combine flashlight Reflector Condenser Lens Imaging Lens Thing with Shutter

5. Combine flashlight Reflector Condenser Lens Imaging Lens Shutter Thing with Viewing Screen

6. After combining you should have a Film Projector

7. Find Film

You are safe from Madman Mercer for now.

>combine flashlight with reflector
You fuse together Flashlight and Reflector.

You now have a flashlight Reflector Thing.

You are safe from Madman Mercer for now.

>Combine flashlight Reflector Thing with Condenser Lens
You can't see any such thing.

I beg your pardon?

>Combine flashlight Reflector Thing with Condenser Lens
You can't see any such thing.

>i
You are carrying:
  flashlight Reflector Thing (providing light)
  an Instruction Manual
  dirty paper
  small paper
  stinky key
  soggy paper
  Imaging Lens
  Viewing Screen
  a red key
  wrinkled paper
  shutter
  scrap of paper
  fancy key

You are safe from Madman Mercer for now.

>sw
Convenience Store
A small family run convenience store filled with racks of snack, and a fridge of drinks.  The exit to Cultural Plaza is to the northeast.

You can see racks of snacks, Condenser Lens, and a Store Clerk here.

You are safe from Madman Mercer for now.

>take condenser lens
Taken.

You are safe from Madman Mercer for now.

>x manual
How to Build a Film Projector for Dummies:

Steps:

*note: must combine in this order

1. Combine flashlight with Reflector

2. Combine flashlight Reflector Thing with Condenser Lens

3. Combine flashlight Reflector Condenser Lens Thing with Imaging Lens

4. Combine flashlight Reflector Condenser Lens Imaging Lens Thing with Shutter

5. Combine flashlight Reflector Condenser Lens Imaging Lens Shutter Thing with Viewing Screen

6. After combining you should have a Film Projector

7. Find Film

You are safe from Madman Mercer for now.

>Combine flashlight Reflector Thing with Condenser Lens
You fuse together flashlight Reflector Thing and Condenser Lens.

You now have a flashlight Reflector Condenser Lens Thing.

You are safe from Madman Mercer for now.

>go ne
Cultural Plaza
The center of this nice little mall with stores surrounding you, and bushes decorating the outside.  It is outdoors and deserted.  No one is sitting on the benches like they usually do.
  
There is a nice little directory here too, showing all the stores.

You can see a worn out book here.

You are safe from Madman Mercer for now.

>go n
Stage
A large stage used for lion dance shows, Kung Fu performance, and many other performances or events.  There is a red door leading to the backstage.  The exit to Cultural Plaza is to the south.

You can see a red door here.

You are safe from Madman Mercer for now.

>unlock red door with red key
You unlock the red door.

You are safe from Madman Mercer for now.

>open red door
You open the red door.

You are safe from Madman Mercer for now.

>go n
Backstage
A strange room that you wouldn't have guessed to be behind the stage of Cultual Plaza.  The room surrounds you with metal walls and a very bright light, like the ones they use in surgeries hanging from the ceiling.

A metal box the size of an Xbox 360, that has a dial which can spin to number.  It looks very solid, so I wouldn't waste your energy on trying force it open.

You can also see a red door here.

You are safe from Madman Mercer for now.

>spin dial to 1384
Clonk! and the metal door swings slowly open, revealing Film Footage.

You are safe from Madman Mercer for now.

>take film footage
Taken.

You hear the speedy swings of the machete cutting the air.

You are safe from Madman Mercer for now.

>play film footage
you put the film into the projector and you start the projector up.  It starts playing a movie of the movie theater that your friends are at.  You start feeling drowsy and you fall unconcious.  You wake up at the movie theater next to your friends.  You ask them about your absence.  They tell you that you were sleeping the whole time.  Maybe it was all a dream?

    *** You have won ***

Would you like to RESTART, RESTORE a saved game, QUIT, or UNDO the last command?

* * *

>s
Cultural Plaza
The center of this nice little mall with stores surrounding you, and bushes decorating the outside.  It is outdoors and deserted.  No one is sitting on the benches like they usually do.
  
There is a nice little directory here too, showing all the stores.

You can see a worn out book and an Instruction Manual here.

You are safe from Madman Mercer for now.

>nw
Hair Salon
A hair salon with little pieces of hair on the floor everywhere.  You see a beautiful safe.  The exit to Cultural Plaza is to the southeast.

You hear the speedy swings of the machete cutting the air.
You can hear the loud heavy footsteps from the Madman Mercer as he walks into the room,  I would recommend not staying too long in this room.

Madman Mercer looks into your soul with his blood shot eyes running at you.  I wouldn't be in his line of sight for too long if i were you.

>unfo
That's not a verb I recognise.

>undo
Hair Salon
[Previous turn undone.]

>undo
Cultural Plaza
[Previous turn undone.]

>w
Fruit store
Many different baskets of fruit fill the store.  The exit to Cultural Plaza is to the east.

You can see green basket (in which is pears), pink basket (in which is peaches), and a red basket (in which is Apples) here.

The red basket catches your attention.

You are safe from Madman Mercer for now.

* * *

>take apples
you take the apples and revealed a flashlight.

You are safe from Madman Mercer for now.

>take flashlight
taken
You hear the speedy swings of the machete cutting the air.

You are safe from Madman Mercer for now.

>undo
Fruit store
[Previous turn undone.]

>undo
Fruit store
[Previous turn undone.]

>take apple
you take the apples and revealed a flashlight.

You are safe from Madman Mercer for now.

>take flashlight
taken
You are safe from Madman Mercer for now.

>e
Cultural Plaza
The center of this nice little mall with stores surrounding you, and bushes decorating the outside.  It is outdoors and deserted.  No one is sitting on the benches like they usually do.
  
There is a nice little directory here too, showing all the stores.

You can see Madman Mercer, a worn out book, and an Instruction Manual here.

>n
Stage
A large stage used for lion dance shows, Kung Fu performance, and many other performances or events.  There is a red door leading to the backstage.  The exit to Cultural Plaza is to the south.

You can see a red door here.

You are safe from Madman Mercer for now.

>s
Cultural Plaza
The center of this nice little mall with stores surrounding you, and bushes decorating the outside.  It is outdoors and deserted.  No one is sitting on the benches like they usually do.
  
There is a nice little directory here too, showing all the stores.

You can see Madman Mercer, a worn out book, and an Instruction Manual here.

>s
Fish Market
Fishy smelling market where you can hear the clueless chinese fisherman who is unaware of Madman Mercer, yelling in his accent "Come get yo ninety nine sense fish.  Veeery cheap fish.".  The exit to Cultural Plaza is to the north.

You can see Reflector and a chinese fisherman here.

You are safe from Madman Mercer for now.

>n
Cultural Plaza
The center of this nice little mall with stores surrounding you, and bushes decorating the outside.  It is outdoors and deserted.  No one is sitting on the benches like they usually do.
  
There is a nice little directory here too, showing all the stores.

You can see Madman Mercer, a worn out book, and an Instruction Manual here.

>undp
That's not a verb I recognise.

>undo
Cultural Plaza
[Previous turn undone.]

>restart
Are you sure you want to restart?